"Code";"Name";"total;place of residence;as of 30 June;total;2024;[person]";"in urban areas;place of residence;as of 30 June;total;2024;[person]";"in rural areas;place of residence;as of 30 June;total;2024;[person]";
0201000;"Powiat bolesławiecki";87473;40941;46532;
0201000;"Powiat bolesławiecki - URBAN GMINAS";36864;36864;0;
0201000;"Powiat bolesławiecki - URBAN-RURAL GMINAS";14591;4077;10514;
0201011;"Bolesławiec (1)";36864;36864;0;
0201022;"Bolesławiec (2)";15338;0;15338;
0201032;"Gromadka (2)";4997;0;4997;
0201043;"Nowogrodziec (3)";14591;4077;10514;
0201044;"Nowogrodziec - urban area (4)";4077;4077;0;
0201045;"Nowogrodziec - rural area (5)";10514;0;10514;
0201052;"Osiecznica (2)";7267;0;7267;
0201062;"Warta Bolesławiecka (2)";8416;0;8416;
0202000;"Powiat dzierżoniowski";94304;73607;20697;
0202000;"Powiat dzierżoniowski - URBAN GMINAS";64181;64181;0;
0202000;"Powiat dzierżoniowski - URBAN-RURAL GMINAS";13899;9426;4473;
0202011;"Bielawa (1)";27874;27874;0;
0202021;"Dzierżoniów (1)";30443;30443;0;
0202033;"Pieszyce (3)";8888;6753;2135;
0202034;"Pieszyce - urban area (4)";6753;6753;0;
0202035;"Pieszyce - rural area (5)";2135;0;2135;
0202041;"Piława Górna (1)";5864;5864;0;
0202052;"Dzierżoniów (2)";9155;0;9155;
0202062;"Łagiewniki (2)";7069;0;7069;
0202073;"Niemcza (3)";5011;2673;2338;
0202074;"Niemcza - urban area (4)";2673;2673;0;
0202075;"Niemcza - rural area (5)";2338;0;2338;
0203000;"Powiat głogowski";84755;61675;23080;
0203000;"Powiat głogowski - URBAN GMINAS";61675;61675;0;
0203011;"Głogów (1)";61675;61675;0;
0203022;"Głogów (2)";7228;0;7228;
0203032;"Jerzmanowa (2)";5920;0;5920;
0203042;"Kotla (2)";4420;0;4420;
0203052;"Pęcław (2)";2111;0;2111;
0203062;"Żukowice (2)";3401;0;3401;
0204000;"Powiat górowski";32250;13197;19053;
0204000;"Powiat górowski - URBAN-RURAL GMINAS";25085;13197;11888;
0204013;"Góra (3)";18382;10669;7713;
0204014;"Góra - urban area (4)";10669;10669;0;
0204015;"Góra - rural area (5)";7713;0;7713;
0204022;"Jemielno (2)";2680;0;2680;
0204032;"Niechlów (2)";4485;0;4485;
0204043;"Wąsosz (3)";6703;2528;4175;
0204044;"Wąsosz - urban area (4)";2528;2528;0;
0204045;"Wąsosz - rural area (5)";4175;0;4175;
0205000;"Powiat jaworski";47039;25021;22018;
0205000;"Powiat jaworski - URBAN GMINAS";20390;20390;0;
0205000;"Powiat jaworski - URBAN-RURAL GMINAS";9550;4631;4919;
0205011;"Jawor (1)";20390;20390;0;
0205023;"Bolków (3)";9550;4631;4919;
0205024;"Bolków - urban area (4)";4631;4631;0;
0205025;"Bolków - rural area (5)";4919;0;4919;
0205032;"Męcinka (2)";5232;0;5232;
0205042;"Mściwojów (2)";3963;0;3963;
0205052;"Paszowice (2)";4207;0;4207;
0205062;"Wądroże Wielkie (2)";3697;0;3697;
0206000;"Powiat karkonoski";60232;25232;35000;
0206000;"Powiat karkonoski - URBAN GMINAS";25232;25232;0;
0206011;"Karpacz (1)";4175;4175;0;
0206021;"Kowary (1)";9616;9616;0;
0206031;"Piechowice (1)";5725;5725;0;
0206041;"Szklarska Poręba (1)";5716;5716;0;
0206052;"Janowice Wielkie (2)";4057;0;4057;
0206062;"Jeżów Sudecki (2)";7943;0;7943;
0206072;"Mysłakowice (2)";9600;0;9600;
0206082;"Podgórzyn (2)";8137;0;8137;
0206092;"Stara Kamienica (2)";5263;0;5263;
0207000;"Powiat kamiennogórski";40040;22442;17598;
0207000;"Powiat kamiennogórski - URBAN GMINAS";16942;16942;0;
0207000;"Powiat kamiennogórski - URBAN-RURAL GMINAS";10072;5500;4572;
0207011;"Kamienna Góra (1)";16942;16942;0;
0207022;"Kamienna Góra (2)";8810;0;8810;
0207033;"Lubawka (3)";10072;5500;4572;
0207034;"Lubawka - urban area (4)";5500;5500;0;
0207035;"Lubawka - rural area (5)";4572;0;4572;
0207042;"Marciszów (2)";4216;0;4216;
0208000;"Powiat kłodzki";146041;92022;54019;
0208000;"Powiat kłodzki - URBAN GMINAS";63917;63917;0;
0208000;"Powiat kłodzki - URBAN-RURAL GMINAS";53210;28105;25105;
0208011;"Duszniki-Zdrój (1)";3946;3946;0;
0208021;"Kłodzko (1)";24672;24672;0;
0208031;"Kudowa-Zdrój (1)";9198;9198;0;
0208041;"Nowa Ruda (1)";20217;20217;0;
0208051;"Polanica-Zdrój (1)";5884;5884;0;
0208063;"Bystrzyca Kłodzka (3)";17116;8858;8258;
0208064;"Bystrzyca Kłodzka - urban area (4)";8858;8858;0;
0208065;"Bystrzyca Kłodzka - rural area (5)";8258;0;8258;
0208072;"Kłodzko (2)";16429;0;16429;
0208083;"Lądek-Zdrój (3)";7434;4914;2520;
0208084;"Lądek-Zdrój - urban area (4)";4914;4914;0;
0208085;"Lądek-Zdrój - rural area (5)";2520;0;2520;
0208092;"Lewin Kłodzki (2)";1962;0;1962;
0208103;"Międzylesie (3)";6740;2374;4366;
0208104;"Międzylesie - urban area (4)";2374;2374;0;
0208105;"Międzylesie - rural area (5)";4366;0;4366;
0208112;"Nowa Ruda (2)";10523;0;10523;
0208123;"Radków (3)";8360;2237;6123;
0208124;"Radków - urban area (4)";2237;2237;0;
0208125;"Radków - rural area (5)";6123;0;6123;
0208133;"Stronie Śląskie (3)";6721;4956;1765;
0208134;"Stronie Śląskie - urban area (4)";4956;4956;0;
0208135;"Stronie Śląskie - rural area (5)";1765;0;1765;
0208143;"Szczytna (3)";6839;4766;2073;
0208144;"Szczytna - urban area (4)";4766;4766;0;
0208145;"Szczytna - rural area (5)";2073;0;2073;
0209000;"Powiat legnicki";55068;15779;39289;
0209000;"Powiat legnicki - URBAN GMINAS";12289;12289;0;
0209000;"Powiat legnicki - URBAN-RURAL GMINAS";7100;3490;3610;
0209011;"Chojnów (1)";12289;12289;0;
0209022;"Chojnów (2)";9456;0;9456;
0209032;"Krotoszyce (2)";3340;0;3340;
0209042;"Kunice (2)";7797;0;7797;
0209052;"Legnickie Pole (2)";5345;0;5345;
0209062;"Miłkowice (2)";7340;0;7340;
0209073;"Prochowice (3)";7100;3490;3610;
0209074;"Prochowice - urban area (4)";3490;3490;0;
0209075;"Prochowice - rural area (5)";3610;0;3610;
0209082;"Ruja (2)";2401;0;2401;
0210000;"Powiat lubański";51171;31588;19583;
0210000;"Powiat lubański - URBAN GMINAS";23343;23343;0;
0210000;"Powiat lubański - URBAN-RURAL GMINAS";15471;8245;7226;
0210011;"Lubań (1)";19407;19407;0;
0210021;"Świeradów-Zdrój (1)";3936;3936;0;
0210033;"Leśna (3)";9214;3965;5249;
0210034;"Leśna - urban area (4)";3965;3965;0;
0210035;"Leśna - rural area (5)";5249;0;5249;
0210042;"Lubań (2)";6462;0;6462;
0210053;"Olszyna (3)";6257;4280;1977;
0210054;"Olszyna - urban area (4)";4280;4280;0;
0210055;"Olszyna - rural area (5)";1977;0;1977;
0210062;"Platerówka (2)";1507;0;1507;
0210072;"Siekierczyn (2)";4388;0;4388;
0211000;"Powiat lubiński";102578;72400;30178;
0211000;"Powiat lubiński - URBAN GMINAS";67155;67155;0;
0211000;"Powiat lubiński - URBAN-RURAL GMINAS";9345;5245;4100;
0211011;"Lubin (1)";67155;67155;0;
0211022;"Lubin (2)";18674;0;18674;
0211032;"Rudna (2)";7404;0;7404;
0211043;"Ścinawa (3)";9345;5245;4100;
0211044;"Ścinawa - urban area (4)";5245;5245;0;
0211045;"Ścinawa - rural area (5)";4100;0;4100;
0212000;"Powiat lwówecki";42622;21085;21537;
0212000;"Powiat lwówecki - URBAN-RURAL GMINAS";42622;21085;21537;
0212013;"Gryfów Śląski (3)";9034;6066;2968;
0212014;"Gryfów Śląski - urban area (4)";6066;6066;0;
0212015;"Gryfów Śląski - rural area (5)";2968;0;2968;
0212023;"Lubomierz (3)";5609;1780;3829;
0212024;"Lubomierz - urban area (4)";1780;1780;0;
0212025;"Lubomierz - rural area (5)";3829;0;3829;
0212033;"Lwówek Śląski (3)";15968;8072;7896;
0212034;"Lwówek Śląski - urban area (4)";8072;8072;0;
0212035;"Lwówek Śląski - rural area (5)";7896;0;7896;
0212043;"Mirsk (3)";8113;3593;4520;
0212044;"Mirsk - urban area (4)";3593;3593;0;
0212045;"Mirsk - rural area (5)";4520;0;4520;
0212053;"Wleń (3)";3898;1574;2324;
0212054;"Wleń - urban area (4)";1574;1574;0;
0212055;"Wleń - rural area (5)";2324;0;2324;
0213000;"Powiat milicki";35454;10669;24785;
0213000;"Powiat milicki - URBAN-RURAL GMINAS";22934;10669;12265;
0213012;"Cieszków (2)";4557;0;4557;
0213022;"Krośnice (2)";7963;0;7963;
0213033;"Milicz (3)";22934;10669;12265;
0213034;"Milicz - urban area (4)";10669;10669;0;
0213035;"Milicz - rural area (5)";12265;0;12265;
0214000;"Powiat oleśnicki";106563;57783;48780;
0214000;"Powiat oleśnicki - URBAN GMINAS";35002;35002;0;
0214000;"Powiat oleśnicki - URBAN-RURAL GMINAS";43200;22781;20419;
0214011;"Oleśnica (1)";35002;35002;0;
0214023;"Bierutów (3)";9226;4431;4795;
0214024;"Bierutów - urban area (4)";4431;4431;0;
0214025;"Bierutów - rural area (5)";4795;0;4795;
0214032;"Dobroszyce (2)";7336;0;7336;
0214042;"Dziadowa Kłoda (2)";4558;0;4558;
0214053;"Międzybórz (3)";4996;2299;2697;
0214054;"Międzybórz - urban area (4)";2299;2299;0;
0214055;"Międzybórz - rural area (5)";2697;0;2697;
0214062;"Oleśnica (2)";16467;0;16467;
0214073;"Syców (3)";16487;9922;6565;
0214074;"Syców - urban area (4)";9922;9922;0;
0214075;"Syców - rural area (5)";6565;0;6565;
0214083;"Twardogóra (3)";12491;6129;6362;
0214084;"Twardogóra - urban area (4)";6129;6129;0;
0214085;"Twardogóra - rural area (5)";6362;0;6362;
0215000;"Powiat oławski";77429;48049;29380;
0215000;"Powiat oławski - URBAN GMINAS";33100;33100;0;
0215000;"Powiat oławski - URBAN-RURAL GMINAS";23752;14949;8803;
0215011;"Oława (1)";33100;33100;0;
0215022;"Domaniów (2)";4893;0;4893;
0215033;"Jelcz-Laskowice (3)";23752;14949;8803;
0215034;"Jelcz-Laskowice - urban area (4)";14949;14949;0;
0215035;"Jelcz-Laskowice - rural area (5)";8803;0;8803;
0215042;"Oława (2)";15684;0;15684;
0216000;"Powiat polkowicki";61055;34092;26963;
0216000;"Powiat polkowicki - URBAN-RURAL GMINAS";46908;34092;12816;
0216013;"Chocianów (3)";12351;7316;5035;
0216014;"Chocianów - urban area (4)";7316;7316;0;
0216015;"Chocianów - rural area (5)";5035;0;5035;
0216022;"Gaworzyce (2)";3741;0;3741;
0216032;"Grębocice (2)";5305;0;5305;
0216043;"Polkowice (3)";26786;21227;5559;
0216044;"Polkowice - urban area (4)";21227;21227;0;
0216045;"Polkowice - rural area (5)";5559;0;5559;
0216053;"Przemków (3)";7771;5549;2222;
0216054;"Przemków - urban area (4)";5549;5549;0;
0216055;"Przemków - rural area (5)";2222;0;2222;
0216062;"Radwanice (2)";5101;0;5101;
0217000;"Powiat strzeliński";41582;14152;27430;
0217000;"Powiat strzeliński - URBAN-RURAL GMINAS";28189;14152;14037;
0217012;"Borów (2)";4975;0;4975;
0217022;"Kondratowice (2)";3951;0;3951;
0217032;"Przeworno (2)";4467;0;4467;
0217043;"Strzelin (3)";21411;11917;9494;
0217044;"Strzelin - urban area (4)";11917;11917;0;
0217045;"Strzelin - rural area (5)";9494;0;9494;
0217053;"Wiązów (3)";6778;2235;4543;
0217054;"Wiązów - urban area (4)";2235;2235;0;
0217055;"Wiązów - rural area (5)";4543;0;4543;
0218000;"Powiat średzki";59482;11630;47852;
0218000;"Powiat średzki - URBAN-RURAL GMINAS";41867;11630;30237;
0218012;"Kostomłoty (2)";7170;0;7170;
0218022;"Malczyce (2)";5662;0;5662;
0218033;"Miękinia (3)";22082;2104;19978;
0218034;"Miękinia - urban area (4)";2104;2104;0;
0218035;"Miękinia - rural area (5)";19978;0;19978;
0218043;"Środa Śląska (3)";19785;9526;10259;
0218044;"Środa Śląska - urban area (4)";9526;9526;0;
0218045;"Środa Śląska - rural area (5)";10259;0;10259;
0218052;"Udanin (2)";4783;0;4783;
0219000;"Powiat świdnicki";149857;100453;49404;
0219000;"Powiat świdnicki - URBAN GMINAS";74177;74177;0;
0219000;"Powiat świdnicki - URBAN-RURAL GMINAS";46362;26276;20086;
0219011;"Świdnica (1)";52417;52417;0;
0219021;"Świebodzice (1)";21760;21760;0;
0219032;"Dobromierz (2)";4887;0;4887;
0219043;"Jaworzyna Śląska (3)";10229;5020;5209;
0219044;"Jaworzyna Śląska - urban area (4)";5020;5020;0;
0219045;"Jaworzyna Śląska - rural area (5)";5209;0;5209;
0219052;"Marcinowice (2)";6365;0;6365;
0219063;"Strzegom (3)";24065;14867;9198;
0219064;"Strzegom - urban area (4)";14867;14867;0;
0219065;"Strzegom - rural area (5)";9198;0;9198;
0219072;"Świdnica (2)";18066;0;18066;
0219083;"Żarów (3)";12068;6389;5679;
0219084;"Żarów - urban area (4)";6389;6389;0;
0219085;"Żarów - rural area (5)";5679;0;5679;
0220000;"Powiat trzebnicki";87738;30828;56910;
0220000;"Powiat trzebnicki - URBAN-RURAL GMINAS";69628;30828;38800;
0220013;"Oborniki Śląskie (3)";21145;8950;12195;
0220014;"Oborniki Śląskie - urban area (4)";8950;8950;0;
0220015;"Oborniki Śląskie - rural area (5)";12195;0;12195;
0220023;"Prusice (3)";9287;2125;7162;
0220024;"Prusice - urban area (4)";2125;2125;0;
0220025;"Prusice - rural area (5)";7162;0;7162;
0220033;"Trzebnica (3)";25068;13583;11485;
0220034;"Trzebnica - urban area (4)";13583;13583;0;
0220035;"Trzebnica - rural area (5)";11485;0;11485;
0220042;"Wisznia Mała (2)";12218;0;12218;
0220052;"Zawonia (2)";5892;0;5892;
0220063;"Żmigród (3)";14128;6170;7958;
0220064;"Żmigród - urban area (4)";6170;6170;0;
0220065;"Żmigród - rural area (5)";7958;0;7958;
0221000;"Powiat wałbrzyski";52524;33577;18947;
0221000;"Powiat wałbrzyski - URBAN GMINAS";23987;23987;0;
0221000;"Powiat wałbrzyski - URBAN-RURAL GMINAS";14175;9590;4585;
0221011;"Boguszów-Gorce (1)";14129;14129;0;
0221021;"Jedlina-Zdrój (1)";4617;4617;0;
0221031;"Szczawno-Zdrój (1)";5241;5241;0;
0221042;"Czarny Bór (2)";4740;0;4740;
0221053;"Głuszyca (3)";8011;5882;2129;
0221054;"Głuszyca - urban area (4)";5882;5882;0;
0221055;"Głuszyca - rural area (5)";2129;0;2129;
0221063;"Mieroszów (3)";6164;3708;2456;
0221064;"Mieroszów - urban area (4)";3708;3708;0;
0221065;"Mieroszów - rural area (5)";2456;0;2456;
0221072;"Stare Bogaczowice (2)";4339;0;4339;
0221082;"Walim (2)";5283;0;5283;
0222000;"Powiat wołowski";45281;24423;20858;
0222000;"Powiat wołowski - URBAN-RURAL GMINAS";37430;24423;13007;
0222013;"Brzeg Dolny (3)";16050;12476;3574;
0222014;"Brzeg Dolny - urban area (4)";12476;12476;0;
0222015;"Brzeg Dolny - rural area (5)";3574;0;3574;
0222022;"Wińsko (2)";7851;0;7851;
0222033;"Wołów (3)";21380;11947;9433;
0222034;"Wołów - urban area (4)";11947;11947;0;
0222035;"Wołów - rural area (5)";9433;0;9433;
0223000;"Powiat wrocławski";189571;25397;164174;
0223000;"Powiat wrocławski - URBAN-RURAL GMINAS";74258;25397;48861;
0223012;"Czernica (2)";24544;0;24544;
0223022;"Długołęka (2)";44486;0;44486;
0223032;"Jordanów Śląski (2)";3282;0;3282;
0223043;"Kąty Wrocławskie (3)";30478;7157;23321;
0223044;"Kąty Wrocławskie - urban area (4)";7157;7157;0;
0223045;"Kąty Wrocławskie - rural area (5)";23321;0;23321;
0223052;"Kobierzyce (2)";25285;0;25285;
0223062;"Mietków (2)";3785;0;3785;
0223073;"Sobótka (3)";13043;7033;6010;
0223074;"Sobótka - urban area (4)";7033;7033;0;
0223075;"Sobótka - rural area (5)";6010;0;6010;
0223083;"Siechnice (3)";30737;11207;19530;
0223084;"Siechnice - urban area (4)";11207;11207;0;
0223085;"Siechnice - rural area (5)";19530;0;19530;
0223092;"Żórawina (2)";13931;0;13931;
0224000;"Powiat ząbkowicki";60264;31135;29129;
0224000;"Powiat ząbkowicki - URBAN-RURAL GMINAS";52341;31135;21206;
0224013;"Bardo (3)";4910;2296;2614;
0224014;"Bardo - urban area (4)";2296;2296;0;
0224015;"Bardo - rural area (5)";2614;0;2614;
0224022;"Ciepłowody (2)";2808;0;2808;
0224033;"Kamieniec Ząbkowicki (3)";7405;4321;3084;
0224034;"Kamieniec Ząbkowicki - urban area (4)";4321;4321;0;
0224035;"Kamieniec Ząbkowicki - rural area (5)";3084;0;3084;
0224042;"Stoszowice (2)";5115;0;5115;
0224053;"Ząbkowice Śląskie (3)";20592;14178;6414;
0224054;"Ząbkowice Śląskie - urban area (4)";14178;14178;0;
0224055;"Ząbkowice Śląskie - rural area (5)";6414;0;6414;
0224063;"Ziębice (3)";15455;7942;7513;
0224064;"Ziębice - urban area (4)";7942;7942;0;
0224065;"Ziębice - rural area (5)";7513;0;7513;
0224073;"Złoty Stok (3)";3979;2398;1581;
0224074;"Złoty Stok - urban area (4)";2398;2398;0;
0224075;"Złoty Stok - rural area (5)";1581;0;1581;
0225000;"Powiat zgorzelecki";84723;56391;28332;
0225000;"Powiat zgorzelecki - URBAN GMINAS";32444;32444;0;
0225000;"Powiat zgorzelecki - URBAN-RURAL GMINAS";37528;23947;13581;
0225011;"Zawidów (1)";3738;3738;0;
0225021;"Zgorzelec (1)";28706;28706;0;
0225033;"Bogatynia (3)";21120;15875;5245;
0225034;"Bogatynia - urban area (4)";15875;15875;0;
0225035;"Bogatynia - rural area (5)";5245;0;5245;
0225043;"Pieńsk (3)";8683;5430;3253;
0225044;"Pieńsk - urban area (4)";5430;5430;0;
0225045;"Pieńsk - rural area (5)";3253;0;3253;
0225052;"Sulików (2)";5811;0;5811;
0225063;"Węgliniec (3)";7725;2642;5083;
0225064;"Węgliniec - urban area (4)";2642;2642;0;
0225065;"Węgliniec - rural area (5)";5083;0;5083;
0225072;"Zgorzelec (2)";8940;0;8940;
0226000;"Powiat złotoryjski";40435;19473;20962;
0226000;"Powiat złotoryjski - URBAN GMINAS";17494;17494;0;
0226000;"Powiat złotoryjski - URBAN-RURAL GMINAS";6971;1979;4992;
0226011;"Wojcieszów (1)";3423;3423;0;
0226021;"Złotoryja (1)";14071;14071;0;
0226032;"Pielgrzymka (2)";4193;0;4193;
0226043;"Świerzawa (3)";6971;1979;4992;
0226044;"Świerzawa - urban area (4)";1979;1979;0;
0226045;"Świerzawa - rural area (5)";4992;0;4992;
0226052;"Zagrodno (2)";4808;0;4808;
0226062;"Złotoryja (2)";6969;0;6969;
0261000;"City with powiat status Jelenia Góra";74636;74636;0;
0261000;"City with powiat status Jelenia Góra - URBAN GMINAS";74636;74636;0;
0261011;"Jelenia Góra (1)";74636;74636;0;
0262000;"City with powiat status Legnica";91335;91335;0;
0262000;"City with powiat status Legnica - URBAN GMINAS";91335;91335;0;
0262011;"Legnica (1)";91335;91335;0;
0264000;"City with powiat status Wrocław";673531;673531;0;
0264000;"City with powiat status Wrocław - URBAN GMINAS";673531;673531;0;
0264011;"Wrocław (1)";673531;673531;0;
0265000;"City with powiat status Wałbrzych since 2013";99463;99463;0;
0265000;"City with powiat status Wałbrzych since 2013 - URBAN GMINAS";99463;99463;0;
0265011;"Wałbrzych since 2013 (1)";99463;99463;0;
0401000;"Powiat aleksandrowski";53325;23336;29989;
0401000;"Powiat aleksandrowski - URBAN GMINAS";23336;23336;0;
0401011;"Aleksandrów Kujawski (1)";11475;11475;0;
0401021;"Ciechocinek (1)";10113;10113;0;
0401031;"Nieszawa (1)";1748;1748;0;
0401042;"Aleksandrów Kujawski (2)";12014;0;12014;
0401052;"Bądkowo (2)";4014;0;4014;
0401062;"Koneck (2)";3084;0;3084;
0401072;"Raciążek (2)";3151;0;3151;
0401082;"Waganiec (2)";4404;0;4404;
0401092;"Zakrzewo (2)";3322;0;3322;
0402000;"Powiat brodnicki";77593;33127;44466;
0402000;"Powiat brodnicki - URBAN GMINAS";28104;28104;0;
0402000;"Powiat brodnicki - URBAN-RURAL GMINAS";12105;5023;7082;
0402011;"Brodnica (1)";28104;28104;0;
0402022;"Bobrowo (2)";6014;0;6014;
0402032;"Brodnica (2)";9551;0;9551;
0402042;"Brzozie (2)";3704;0;3704;
0402053;"Górzno (3)";3718;1378;2340;
0402054;"Górzno - urban area (4)";1378;1378;0;
0402055;"Górzno - rural area (5)";2340;0;2340;
0402062;"Bartniczka (2)";4552;0;4552;
0402073;"Jabłonowo Pomorskie (3)";8387;3645;4742;
0402074;"Jabłonowo Pomorskie - urban area (4)";3645;3645;0;
0402075;"Jabłonowo Pomorskie - rural area (5)";4742;0;4742;
0402082;"Osiek (2)";3765;0;3765;
0402092;"Świedziebnia (2)";4848;0;4848;
0402102;"Zbiczno (2)";4950;0;4950;
0403000;"Powiat bydgoski";127585;25861;101724;
0403000;"Powiat bydgoski - URBAN-RURAL GMINAS";39522;25861;13661;
0403012;"Białe Błota (2)";26354;0;26354;
0403022;"Dąbrowa Chełmińska (2)";8635;0;8635;
0403032;"Dobrcz (2)";12857;0;12857;
0403043;"Koronowo (3)";23218;10679;12539;
0403044;"Koronowo - urban area (4)";10679;10679;0;
0403045;"Koronowo - rural area (5)";12539;0;12539;
0403052;"Nowa Wieś Wielka (2)";10382;0;10382;
0403062;"Osielsko (2)";18835;0;18835;
0403072;"Sicienko (2)";11000;0;11000;
0403083;"Solec Kujawski (3)";16304;15182;1122;
0403084;"Solec Kujawski - urban area (4)";15182;15182;0;
0403085;"Solec Kujawski - rural area (5)";1122;0;1122;
0404000;"Powiat chełmiński";48924;17952;30972;
0404000;"Powiat chełmiński - URBAN GMINAS";17952;17952;0;
0404011;"Chełmno (1)";17952;17952;0;
0404022;"Chełmno (2)";6064;0;6064;
0404032;"Kijewo Królewskie (2)";4299;0;4299;
0404042;"Lisewo (2)";4831;0;4831;
0404052;"Papowo Biskupie (2)";3946;0;3946;
0404062;"Stolno (2)";5170;0;5170;
0404072;"Unisław (2)";6662;0;6662;
0405000;"Powiat golubsko-dobrzyński";43185;15253;27932;
0405000;"Powiat golubsko-dobrzyński - URBAN GMINAS";11205;11205;0;
0405000;"Powiat golubsko-dobrzyński - URBAN-RURAL GMINAS";11140;4048;7092;
0405011;"Golub-Dobrzyń (1)";11205;11205;0;
0405022;"Ciechocin (2)";3834;0;3834;
0405032;"Golub-Dobrzyń (2)";8878;0;8878;
0405043;"Kowalewo Pomorskie (3)";11140;4048;7092;
0405044;"Kowalewo Pomorskie - urban area (4)";4048;4048;0;
0405045;"Kowalewo Pomorskie - rural area (5)";7092;0;7092;
0405052;"Radomin (2)";3938;0;3938;
0405062;"Zbójno (2)";4190;0;4190;
0406000;"Powiat grudziądzki";39110;4815;34295;
0406000;"Powiat grudziądzki - URBAN-RURAL GMINAS";11657;4815;6842;
0406012;"Grudziądz (2)";13827;0;13827;
0406022;"Gruta (2)";5982;0;5982;
0406033;"Łasin (3)";7264;3036;4228;
0406034;"Łasin - urban area (4)";3036;3036;0;
0406035;"Łasin - rural area (5)";4228;0;4228;
0406043;"Radzyń Chełmiński (3)";4393;1779;2614;
0406044;"Radzyń Chełmiński - urban area (4)";1779;1779;0;
0406045;"Radzyń Chełmiński - rural area (5)";2614;0;2614;
0406052;"Rogóźno (2)";3948;0;3948;
0406062;"Świecie nad Osą (2)";3696;0;3696;
0407000;"Powiat inowrocławski";149836;95893;53943;
0407000;"Powiat inowrocławski - URBAN GMINAS";67041;67041;0;
0407000;"Powiat inowrocławski - URBAN-RURAL GMINAS";52689;28852;23837;
0407011;"Inowrocław (1)";67041;67041;0;
0407022;"Dąbrowa Biskupia (2)";4911;0;4911;
0407033;"Gniewkowo (3)";13532;6639;6893;
0407034;"Gniewkowo - urban area (4)";6639;6639;0;
0407035;"Gniewkowo - rural area (5)";6893;0;6893;
0407042;"Inowrocław (2)";11972;0;11972;
0407053;"Janikowo (3)";12344;8071;4273;
0407054;"Janikowo - urban area (4)";8071;8071;0;
0407055;"Janikowo - rural area (5)";4273;0;4273;
0407063;"Kruszwica (3)";17692;9026;8666;
0407064;"Kruszwica - urban area (4)";9026;9026;0;
0407065;"Kruszwica - rural area (5)";8666;0;8666;
0407073;"Pakość (3)";9121;5116;4005;
0407074;"Pakość - urban area (4)";5116;5116;0;
0407075;"Pakość - rural area (5)";4005;0;4005;
0407082;"Rojewo (2)";4412;0;4412;
0407092;"Złotniki Kujawskie (2)";8811;0;8811;
0408000;"Powiat lipnowski";62337;21834;40503;
0408000;"Powiat lipnowski - URBAN GMINAS";13331;13331;0;
0408000;"Powiat lipnowski - URBAN-RURAL GMINAS";23643;8503;15140;
0408011;"Lipno (1)";13331;13331;0;
0408023;"Bobrowniki (3)";2978;1128;1850;
0408024;"Bobrowniki - urban area (4)";1128;1128;0;
0408025;"Bobrowniki - rural area (5)";1850;0;1850;
0408032;"Chrostkowo (2)";2766;0;2766;
0408043;"Dobrzyń nad Wisłą (3)";7034;1940;5094;
0408044;"Dobrzyń nad Wisłą - urban area (4)";1940;1940;0;
0408045;"Dobrzyń nad Wisłą - rural area (5)";5094;0;5094;
0408053;"Kikół (3)";6630;2045;4585;
0408054;"Kikół - urban area (4)";2045;2045;0;
0408055;"Kikół - rural area (5)";4585;0;4585;
0408062;"Lipno (2)";11526;0;11526;
0408073;"Skępe (3)";7001;3390;3611;
0408074;"Skępe - urban area (4)";3390;3390;0;
0408075;"Skępe - rural area (5)";3611;0;3611;
0408082;"Tłuchowo (2)";4419;0;4419;
0408092;"Wielgie (2)";6652;0;6652;
0409000;"Powiat mogileński";43407;16093;27314;
0409000;"Powiat mogileński - URBAN-RURAL GMINAS";34566;16093;18473;
0409012;"Dąbrowa (2)";4309;0;4309;
0409022;"Jeziora Wielkie (2)";4532;0;4532;
0409033;"Mogilno (3)";23752;10895;12857;
0409034;"Mogilno - urban area (4)";10895;10895;0;
0409035;"Mogilno - rural area (5)";12857;0;12857;
0409043;"Strzelno (3)";10814;5198;5616;
0409044;"Strzelno - urban area (4)";5198;5198;0;
0409045;"Strzelno - rural area (5)";5616;0;5616;
0410000;"Powiat nakielski";82605;34566;48039;
0410000;"Powiat nakielski - URBAN-RURAL GMINAS";75685;34566;41119;
0410013;"Kcynia (3)";12074;4215;7859;
0410014;"Kcynia - urban area (4)";4215;4215;0;
0410015;"Kcynia - rural area (5)";7859;0;7859;
0410023;"Mrocza (3)";8812;4102;4710;
0410024;"Mrocza - urban area (4)";4102;4102;0;
0410025;"Mrocza - rural area (5)";4710;0;4710;
0410033;"Nakło nad Notecią (3)";29627;16884;12743;
0410034;"Nakło nad Notecią - urban area (4)";16884;16884;0;
0410035;"Nakło nad Notecią - rural area (5)";12743;0;12743;
0410042;"Sadki (2)";6920;0;6920;
0410053;"Szubin (3)";25172;9365;15807;
0410054;"Szubin - urban area (4)";9365;9365;0;
0410055;"Szubin - rural area (5)";15807;0;15807;
0411000;"Powiat radziejowski";37571;9173;28398;
0411000;"Powiat radziejowski - URBAN GMINAS";5006;5006;0;
0411000;"Powiat radziejowski - URBAN-RURAL GMINAS";8579;4167;4412;
0411011;"Radziejów (1)";5006;5006;0;
0411022;"Bytoń (2)";3298;0;3298;
0411032;"Dobre (2)";4845;0;4845;
0411042;"Osięciny (2)";7128;0;7128;
0411053;"Piotrków Kujawski (3)";8579;4167;4412;
0411054;"Piotrków Kujawski - urban area (4)";4167;4167;0;
0411055;"Piotrków Kujawski - rural area (5)";4412;0;4412;
0411062;"Radziejów (2)";4248;0;4248;
0411072;"Topólka (2)";4467;0;4467;
0412000;"Powiat rypiński";40989;15298;25691;
0412000;"Powiat rypiński - URBAN GMINAS";15298;15298;0;
0412011;"Rypin (1)";15298;15298;0;
0412022;"Brzuze (2)";4807;0;4807;
0412032;"Rogowo (2)";4579;0;4579;
0412042;"Rypin (2)";7289;0;7289;
0412052;"Skrwilno (2)";5342;0;5342;
0412062;"Wąpielsk (2)";3674;0;3674;
0413000;"Powiat sępoleński";38702;16592;22110;
0413000;"Powiat sępoleński - URBAN-RURAL GMINAS";34262;16592;17670;
0413013;"Kamień Krajeński (3)";6478;2318;4160;
0413014;"Kamień Krajeński - urban area (4)";2318;2318;0;
0413015;"Kamień Krajeński - rural area (5)";4160;0;4160;
0413023;"Sępólno Krajeńskie (3)";15023;8684;6339;
0413024;"Sępólno Krajeńskie - urban area (4)";8684;8684;0;
0413025;"Sępólno Krajeńskie - rural area (5)";6339;0;6339;
0413032;"Sośno (2)";4440;0;4440;
0413043;"Więcbork (3)";12761;5590;7171;
0413044;"Więcbork - urban area (4)";5590;5590;0;
0413045;"Więcbork - rural area (5)";7171;0;7171;
0414000;"Powiat świecki";94557;32945;61612;
0414000;"Powiat świecki - URBAN-RURAL GMINAS";51479;32945;18534;
0414012;"Bukowiec (2)";4864;0;4864;
0414022;"Dragacz (2)";6787;0;6787;
0414032;"Drzycim (2)";4764;0;4764;
0414042;"Jeżewo (2)";7659;0;7659;
0414052;"Lniano (2)";4040;0;4040;
0414063;"Nowe (3)";9605;5372;4233;
0414064;"Nowe - urban area (4)";5372;5372;0;
0414065;"Nowe - rural area (5)";4233;0;4233;
0414072;"Osie (2)";5395;0;5395;
0414083;"Pruszcz (3)";9142;2771;6371;
0414084;"Pruszcz - urban area (4)";2771;2771;0;
0414085;"Pruszcz - rural area (5)";6371;0;6371;
0414093;"Świecie (3)";32732;24802;7930;
0414094;"Świecie - urban area (4)";24802;24802;0;
0414095;"Świecie - rural area (5)";7930;0;7930;
0414102;"Świekatowo (2)";3516;0;3516;
0414112;"Warlubie (2)";6053;0;6053;
0415000;"Powiat toruński";114633;13620;101013;
0415000;"Powiat toruński - URBAN GMINAS";13620;13620;0;
0415011;"Chełmża (1)";13620;13620;0;
0415022;"Chełmża (2)";9446;0;9446;
0415032;"Czernikowo (2)";8850;0;8850;
0415042;"Lubicz (2)";21286;0;21286;
0415052;"Łubianka (2)";8191;0;8191;
0415062;"Łysomice (2)";10975;0;10975;
0415072;"Obrowo (2)";20769;0;20769;
0415082;"Wielka Nieszawka (2)";5202;0;5202;
0415092;"Zławieś Wielka (2)";16294;0;16294;
0416000;"Powiat tucholski";46848;12915;33933;
0416000;"Powiat tucholski - URBAN-RURAL GMINAS";19534;12915;6619;
0416012;"Cekcyn (2)";6783;0;6783;
0416022;"Gostycyn (2)";4880;0;4880;
0416032;"Kęsowo (2)";4230;0;4230;
0416042;"Lubiewo (2)";5808;0;5808;
0416052;"Śliwice (2)";5613;0;5613;
0416063;"Tuchola (3)";19534;12915;6619;
0416064;"Tuchola - urban area (4)";12915;12915;0;
0416065;"Tuchola - rural area (5)";6619;0;6619;
0417000;"Powiat wąbrzeski";32298;12820;19478;
0417000;"Powiat wąbrzeski - URBAN GMINAS";12820;12820;0;
0417011;"Wąbrzeźno (1)";12820;12820;0;
0417022;"Dębowa Łąka (2)";2943;0;2943;
0417032;"Książki (2)";3749;0;3749;
0417042;"Płużnica (2)";4484;0;4484;
0417052;"Ryńsk (2)";8302;0;8302;
0418000;"Powiat włocławski";81876;15875;66001;
0418000;"Powiat włocławski - URBAN GMINAS";3266;3266;0;
0418000;"Powiat włocławski - URBAN-RURAL GMINAS";38793;12609;26184;
0418011;"Kowal (1)";3266;3266;0;
0418022;"Baruchowo (2)";3283;0;3283;
0418032;"Boniewo (2)";3156;0;3156;
0418043;"Brześć Kujawski (3)";11002;4522;6480;
0418044;"Brześć Kujawski - urban area (4)";4522;4522;0;
0418045;"Brześć Kujawski - rural area (5)";6480;0;6480;
0418052;"Choceń (2)";7559;0;7559;
0418063;"Chodecz (3)";5395;1681;3714;
0418064;"Chodecz - urban area (4)";1681;1681;0;
0418065;"Chodecz - rural area (5)";3714;0;3714;
0418072;"Fabianki (2)";10258;0;10258;
0418083;"Izbica Kujawska (3)";7129;2445;4684;
0418084;"Izbica Kujawska - urban area (4)";2445;2445;0;
0418085;"Izbica Kujawska - rural area (5)";4684;0;4684;
0418092;"Kowal (2)";3852;0;3852;
0418102;"Lubanie (2)";4294;0;4294;
0418113;"Lubień Kujawski (3)";6706;1305;5401;
0418114;"Lubień Kujawski - urban area (4)";1305;1305;0;
0418115;"Lubień Kujawski - rural area (5)";5401;0;5401;
0418123;"Lubraniec (3)";8561;2656;5905;
0418124;"Lubraniec - urban area (4)";2656;2656;0;
0418125;"Lubraniec - rural area (5)";5905;0;5905;
0418132;"Włocławek (2)";7415;0;7415;
0419000;"Powiat żniński";67346;29174;38172;
0419000;"Powiat żniński - URBAN-RURAL GMINAS";60775;29174;31601;
0419013;"Barcin (3)";14078;6869;7209;
0419014;"Barcin - urban area (4)";6869;6869;0;
0419015;"Barcin - rural area (5)";7209;0;7209;
0419023;"Gąsawa (3)";4922;1393;3529;
0419024;"Gąsawa - urban area (4)";1393;1393;0;
0419025;"Gąsawa - rural area (5)";3529;0;3529;
0419033;"Janowiec Wielkopolski (3)";8420;3643;4777;
0419034;"Janowiec Wielkopolski - urban area (4)";3643;3643;0;
0419035;"Janowiec Wielkopolski - rural area (5)";4777;0;4777;
0419043;"Łabiszyn (3)";10629;4325;6304;
0419044;"Łabiszyn - urban area (4)";4325;4325;0;
0419045;"Łabiszyn - rural area (5)";6304;0;6304;
0419052;"Rogowo (2)";6571;0;6571;
0419063;"Żnin (3)";22726;12944;9782;
0419064;"Żnin - urban area (4)";12944;12944;0;
0419065;"Żnin - rural area (5)";9782;0;9782;
0461000;"City with powiat status Bydgoszcz";324984;324984;0;
0461000;"City with powiat status Bydgoszcz - URBAN GMINAS";324984;324984;0;
0461011;"Bydgoszcz (1)";324984;324984;0;
0462000;"City with powiat status Grudziądz";88214;88214;0;
0462000;"City with powiat status Grudziądz - URBAN GMINAS";88214;88214;0;
0462011;"Grudziądz (1)";88214;88214;0;
0463000;"City with powiat status Toruń";194273;194273;0;
0463000;"City with powiat status Toruń - URBAN GMINAS";194273;194273;0;
0463011;"Toruń (1)";194273;194273;0;
0464000;"City with powiat status Włocławek";100125;100125;0;
0464000;"City with powiat status Włocławek - URBAN GMINAS";100125;100125;0;
0464011;"Włocławek (1)";100125;100125;0;
0601000;"Powiat bialski";104522;22495;82027;
0601000;"Powiat bialski - URBAN GMINAS";20397;20397;0;
0601000;"Powiat bialski - URBAN-RURAL GMINAS";6677;2098;4579;
0601011;"Międzyrzec Podlaski (1)";15309;15309;0;
0601021;"Terespol (1)";5088;5088;0;
0601032;"Biała Podlaska (2)";15515;0;15515;
0601042;"Drelów (2)";5040;0;5040;
0601052;"Janów Podlaski (2)";4887;0;4887;
0601062;"Kodeń (2)";3224;0;3224;
0601072;"Konstantynów (2)";3739;0;3739;
0601082;"Leśna Podlaska (2)";4070;0;4070;
0601092;"Łomazy (2)";4526;0;4526;
0601102;"Międzyrzec Podlaski (2)";10256;0;10256;
0601113;"Piszczac (3)";6677;2098;4579;
0601114;"Piszczac - urban area (4)";2098;2098;0;
0601115;"Piszczac - rural area (5)";4579;0;4579;
0601122;"Rokitno (2)";2691;0;2691;
0601132;"Rossosz (2)";2053;0;2053;
0601142;"Sławatycze (2)";2232;0;2232;
0601152;"Sosnówka (2)";2095;0;2095;
0601162;"Terespol (2)";5940;0;5940;
0601172;"Tuczna (2)";2720;0;2720;
0601182;"Wisznice (2)";4451;0;4451;
0601192;"Zalesie (2)";4009;0;4009;
0602000;"Powiat biłgorajski";95661;33057;62604;
0602000;"Powiat biłgorajski - URBAN GMINAS";24621;24621;0;
0602000;"Powiat biłgorajski - URBAN-RURAL GMINAS";27383;8436;18947;
0602011;"Biłgoraj (1)";24621;24621;0;
0602022;"Aleksandrów (2)";3146;0;3146;
0602032;"Biłgoraj (2)";13491;0;13491;
0602042;"Biszcza (2)";3698;0;3698;
0602053;"Frampol (3)";5614;1330;4284;
0602054;"Frampol - urban area (4)";1330;1330;0;
0602055;"Frampol - rural area (5)";4284;0;4284;
0602063;"Goraj (3)";3845;894;2951;
0602064;"Goraj - urban area (4)";894;894;0;
0602065;"Goraj - rural area (5)";2951;0;2951;
0602073;"Józefów (3)";6310;2302;4008;
0602074;"Józefów - urban area (4)";2302;2302;0;
0602075;"Józefów - rural area (5)";4008;0;4008;
0602082;"Księżpol (2)";6688;0;6688;
0602092;"Łukowa (2)";3901;0;3901;
0602102;"Obsza (2)";3994;0;3994;
0602112;"Potok Górny (2)";4953;0;4953;
0602123;"Tarnogród (3)";6170;3093;3077;
0602124;"Tarnogród - urban area (4)";3093;3093;0;
0602125;"Tarnogród - rural area (5)";3077;0;3077;
0602132;"Tereszpol (2)";3786;0;3786;
0602143;"Turobin (3)";5444;817;4627;
0602144;"Turobin - urban area (4)";817;817;0;
0602145;"Turobin - rural area (5)";4627;0;4627;
0603000;"Powiat chełmski";73457;7278;66179;
0603000;"Powiat chełmski - URBAN GMINAS";3984;3984;0;
0603000;"Powiat chełmski - URBAN-RURAL GMINAS";12293;3294;8999;
0603011;"Rejowiec Fabryczny (1)";3984;3984;0;
0603022;"Białopole (2)";2808;0;2808;
0603032;"Chełm (2)";15309;0;15309;
0603042;"Dorohusk (2)";5775;0;5775;
0603052;"Dubienka (2)";2069;0;2069;
0603062;"Kamień (2)";4055;0;4055;
0603072;"Leśniowice (2)";3263;0;3263;
0603082;"Rejowiec Fabryczny (2)";3898;0;3898;
0603092;"Ruda-Huta (2)";4076;0;4076;
0603102;"Sawin (2)";5116;0;5116;
0603113;"Siedliszcze (3)";6368;1328;5040;
0603114;"Siedliszcze - urban area (4)";1328;1328;0;
0603115;"Siedliszcze - rural area (5)";5040;0;5040;
0603122;"Wierzbica (2)";4672;0;4672;
0603132;"Wojsławice (2)";3389;0;3389;
0603142;"Żmudź (2)";2750;0;2750;
0603153;"Rejowiec (3)";5925;1966;3959;
0603154;"Rejowiec - urban area (4)";1966;1966;0;
0603155;"Rejowiec - rural area (5)";3959;0;3959;
0604000;"Powiat hrubieszowski";56297;15811;40486;
0604000;"Powiat hrubieszowski - URBAN GMINAS";15811;15811;0;
0604011;"Hrubieszów (1)";15811;15811;0;
0604022;"Dołhobyczów (2)";4572;0;4572;
0604032;"Horodło (2)";4703;0;4703;
0604042;"Hrubieszów (2)";9095;0;9095;
0604052;"Mircze (2)";6140;0;6140;
0604062;"Trzeszczany (2)";3703;0;3703;
0604072;"Uchanie (2)";3970;0;3970;
0604082;"Werbkowice (2)";8303;0;8303;
0605000;"Powiat janowski";42537;12200;30337;
0605000;"Powiat janowski - URBAN-RURAL GMINAS";21105;12200;8905;
0605012;"Batorz (2)";3045;0;3045;
0605022;"Chrzanów (2)";2652;0;2652;
0605032;"Dzwola (2)";5865;0;5865;
0605042;"Godziszów (2)";5430;0;5430;
0605053;"Janów Lubelski (3)";14447;10792;3655;
0605054;"Janów Lubelski - urban area (4)";10792;10792;0;
0605055;"Janów Lubelski - rural area (5)";3655;0;3655;
0605063;"Modliborzyce (3)";6658;1408;5250;
0605064;"Modliborzyce - urban area (4)";1408;1408;0;
0605065;"Modliborzyce - rural area (5)";5250;0;5250;
0605072;"Potok Wielki (2)";4440;0;4440;
0606000;"Powiat krasnostawski";58609;18883;39726;
0606000;"Powiat krasnostawski - URBAN GMINAS";17213;17213;0;
0606000;"Powiat krasnostawski - URBAN-RURAL GMINAS";7630;1670;5960;
0606011;"Krasnystaw (1)";17213;17213;0;
0606022;"Fajsławice (2)";4408;0;4408;
0606032;"Gorzków (2)";3164;0;3164;
0606043;"Izbica (3)";7630;1670;5960;
0606044;"Izbica - urban area (4)";1670;1670;0;
0606045;"Izbica - rural area (5)";5960;0;5960;
0606052;"Krasnystaw (2)";8075;0;8075;
0606062;"Kraśniczyn (2)";3390;0;3390;
0606072;"Łopiennik Górny (2)";3546;0;3546;
0606092;"Rudnik (2)";2682;0;2682;
0606102;"Siennica Różana (2)";3725;0;3725;
0606112;"Żółkiewka (2)";4776;0;4776;
0607000;"Powiat kraśnicki";88693;35066;53627;
0607000;"Powiat kraśnicki - URBAN GMINAS";31055;31055;0;
0607000;"Powiat kraśnicki - URBAN-RURAL GMINAS";16058;4011;12047;
0607011;"Kraśnik (1)";31055;31055;0;
0607023;"Annopol (3)";7943;2302;5641;
0607024;"Annopol - urban area (4)";2302;2302;0;
0607025;"Annopol - rural area (5)";5641;0;5641;
0607032;"Dzierzkowice (2)";5208;0;5208;
0607042;"Gościeradów (2)";6778;0;6778;
0607052;"Kraśnik (2)";6976;0;6976;
0607062;"Szastarka (2)";5388;0;5388;
0607072;"Trzydnik Duży (2)";5873;0;5873;
0607083;"Urzędów (3)";8115;1709;6406;
0607084;"Urzędów - urban area (4)";1709;1709;0;
0607085;"Urzędów - rural area (5)";6406;0;6406;
0607092;"Wilkołaz (2)";5302;0;5302;
0607102;"Zakrzówek (2)";6055;0;6055;
0608000;"Powiat lubartowski";83652;26154;57498;
0608000;"Powiat lubartowski - URBAN GMINAS";19635;19635;0;
0608000;"Powiat lubartowski - URBAN-RURAL GMINAS";17072;6519;10553;
0608011;"Lubartów (1)";19635;19635;0;
0608022;"Abramów (2)";3809;0;3809;
0608032;"Firlej (2)";5629;0;5629;
0608042;"Jeziorzany (2)";2451;0;2451;
0608053;"Kamionka (3)";6511;1717;4794;
0608054;"Kamionka - urban area (4)";1717;1717;0;
0608055;"Kamionka - rural area (5)";4794;0;4794;
0608063;"Kock (3)";5655;2860;2795;
0608064;"Kock - urban area (4)";2860;2860;0;
0608065;"Kock - rural area (5)";2795;0;2795;
0608072;"Lubartów (2)";12113;0;12113;
0608082;"Michów (2)";5383;0;5383;
0608092;"Niedźwiada (2)";6180;0;6180;
0608103;"Ostrów Lubelski (3)";4906;1942;2964;
0608104;"Ostrów Lubelski - urban area (4)";1942;1942;0;
0608105;"Ostrów Lubelski - rural area (5)";2964;0;2964;
0608112;"Ostrówek (2)";3647;0;3647;
0608122;"Serniki (2)";4772;0;4772;
0608132;"Uścimów (2)";2961;0;2961;
0609000;"Powiat lubelski";164947;10308;154639;
0609000;"Powiat lubelski - URBAN-RURAL GMINAS";23446;10308;13138;
0609013;"Bełżyce (3)";12627;5868;6759;
0609014;"Bełżyce - urban area (4)";5868;5868;0;
0609015;"Bełżyce - rural area (5)";6759;0;6759;
0609022;"Borzechów (2)";3741;0;3741;
0609033;"Bychawa (3)";10819;4440;6379;
0609034;"Bychawa - urban area (4)";4440;4440;0;
0609035;"Bychawa - rural area (5)";6379;0;6379;
0609042;"Garbów (2)";8960;0;8960;
0609052;"Głusk (2)";15124;0;15124;
0609062;"Jabłonna (2)";8327;0;8327;
0609072;"Jastków (2)";15600;0;15600;
0609082;"Konopnica (2)";16030;0;16030;
0609092;"Krzczonów (2)";4061;0;4061;
0609102;"Niedrzwica Duża (2)";12081;0;12081;
0609112;"Niemce (2)";22177;0;22177;
0609122;"Strzyżewice (2)";8177;0;8177;
0609132;"Wojciechów (2)";6010;0;6010;
0609142;"Wólka (2)";14570;0;14570;
0609152;"Wysokie (2)";4013;0;4013;
0609162;"Zakrzew (2)";2630;0;2630;
0610000;"Powiat łęczyński";55653;17500;38153;
0610000;"Powiat łęczyński - URBAN-RURAL GMINAS";22234;17500;4734;
0610012;"Cyców (2)";7712;0;7712;
0610022;"Ludwin (2)";5615;0;5615;
0610033;"Łęczna (3)";22234;17500;4734;
0610034;"Łęczna - urban area (4)";17500;17500;0;
0610035;"Łęczna - rural area (5)";4734;0;4734;
0610042;"Milejów (2)";8584;0;8584;
0610052;"Puchaczów (2)";5528;0;5528;
0610062;"Spiczyn (2)";5980;0;5980;
0611000;"Powiat łukowski";100580;29345;71235;
0611000;"Powiat łukowski - URBAN GMINAS";29345;29345;0;
0611011;"Łuków (1)";27009;27009;0;
0611021;"Stoczek Łukowski (1)";2336;2336;0;
0611032;"Adamów (2)";5077;0;5077;
0611042;"Krzywda (2)";9754;0;9754;
0611052;"Łuków (2)";18555;0;18555;
0611062;"Serokomla (2)";3656;0;3656;
0611072;"Stanin (2)";9166;0;9166;
0611082;"Stoczek Łukowski (2)";7168;0;7168;
0611092;"Trzebieszów (2)";7077;0;7077;
0611102;"Wojcieszków (2)";6452;0;6452;
0611112;"Wola Mysłowska (2)";4330;0;4330;
0612000;"Powiat opolski";55337;16745;38592;
0612000;"Powiat opolski - URBAN-RURAL GMINAS";35122;16745;18377;
0612012;"Chodel (2)";6254;0;6254;
0612023;"Józefów nad Wisłą (3)";5992;789;5203;
0612024;"Józefów nad Wisłą - urban area (4)";789;789;0;
0612025;"Józefów nad Wisłą - rural area (5)";5203;0;5203;
0612032;"Karczmiska (2)";5280;0;5280;
0612042;"Łaziska (2)";4532;0;4532;
0612053;"Opole Lubelskie (3)";16092;7783;8309;
0612054;"Opole Lubelskie - urban area (4)";7783;7783;0;
0612055;"Opole Lubelskie - rural area (5)";8309;0;8309;
0612063;"Poniatowa (3)";13038;8173;4865;
0612064;"Poniatowa - urban area (4)";8173;8173;0;
0612065;"Poniatowa - rural area (5)";4865;0;4865;
0612072;"Wilków (2)";4149;0;4149;
0613000;"Powiat parczewski";32020;10118;21902;
0613000;"Powiat parczewski - URBAN-RURAL GMINAS";13622;10118;3504;
0613012;"Dębowa Kłoda (2)";3572;0;3572;
0613022;"Jabłoń (2)";3506;0;3506;
0613032;"Milanów (2)";3328;0;3328;
0613043;"Parczew (3)";13622;10118;3504;
0613044;"Parczew - urban area (4)";10118;10118;0;
0613045;"Parczew - rural area (5)";3504;0;3504;
0613052;"Podedwórze (2)";1479;0;1479;
0613062;"Siemień (2)";4253;0;4253;
0613072;"Sosnowica (2)";2260;0;2260;
0614000;"Powiat puławski";106511;50477;56034;
0614000;"Powiat puławski - URBAN GMINAS";43667;43667;0;
0614000;"Powiat puławski - URBAN-RURAL GMINAS";14792;6810;7982;
0614011;"Puławy (1)";43667;43667;0;
0614022;"Baranów (2)";3516;0;3516;
0614032;"Janowiec (2)";3551;0;3551;
0614043;"Kazimierz Dolny (3)";6250;3220;3030;
0614044;"Kazimierz Dolny - urban area (4)";3220;3220;0;
0614045;"Kazimierz Dolny - rural area (5)";3030;0;3030;
0614052;"Końskowola (2)";8336;0;8336;
0614062;"Kurów (2)";7345;0;7345;
0614072;"Markuszów (2)";2861;0;2861;
0614083;"Nałęczów (3)";8542;3590;4952;
0614084;"Nałęczów - urban area (4)";3590;3590;0;
0614085;"Nałęczów - rural area (5)";4952;0;4952;
0614092;"Puławy (2)";12228;0;12228;
0614102;"Wąwolnica (2)";4150;0;4150;
0614112;"Żyrzyn (2)";6065;0;6065;
0615000;"Powiat radzyński";54764;15503;39261;
0615000;"Powiat radzyński - URBAN GMINAS";14185;14185;0;
0615000;"Powiat radzyński - URBAN-RURAL GMINAS";4039;1318;2721;
0615011;"Radzyń Podlaski (1)";14185;14185;0;
0615022;"Borki (2)";5727;0;5727;
0615033;"Czemierniki (3)";4039;1318;2721;
0615034;"Czemierniki - urban area (4)";1318;1318;0;
0615035;"Czemierniki - rural area (5)";2721;0;2721;
0615042;"Kąkolewnica (2)";7512;0;7512;
0615052;"Komarówka Podlaska (2)";3775;0;3775;
0615062;"Radzyń Podlaski (2)";7888;0;7888;
0615072;"Ulan-Majorat (2)";5504;0;5504;
0615082;"Wohyń (2)";6134;0;6134;
0616000;"Powiat rycki";51233;22930;28303;
0616000;"Powiat rycki - URBAN GMINAS";13998;13998;0;
0616000;"Powiat rycki - URBAN-RURAL GMINAS";19053;8932;10121;
0616011;"Dęblin (1)";13998;13998;0;
0616022;"Kłoczew (2)";6782;0;6782;
0616032;"Nowodwór (2)";3879;0;3879;
0616043;"Ryki (3)";19053;8932;10121;
0616044;"Ryki - urban area (4)";8932;8932;0;
0616045;"Ryki - rural area (5)";10121;0;10121;
0616052;"Stężyca (2)";4717;0;4717;
0616062;"Ułęż (2)";2804;0;2804;
0617000;"Powiat świdnicki";69137;39013;30124;
0617000;"Powiat świdnicki - URBAN GMINAS";36603;36603;0;
0617000;"Powiat świdnicki - URBAN-RURAL GMINAS";10154;2410;7744;
0617011;"Świdnik (1)";36603;36603;0;
0617022;"Mełgiew (2)";10785;0;10785;
0617033;"Piaski (3)";10154;2410;7744;
0617034;"Piaski - urban area (4)";2410;2410;0;
0617035;"Piaski - rural area (5)";7744;0;7744;
0617042;"Rybczewice (2)";3182;0;3182;
0617052;"Trawniki (2)";8413;0;8413;
0618000;"Powiat tomaszowski";76509;23571;52938;
0618000;"Powiat tomaszowski - URBAN GMINAS";17709;17709;0;
0618000;"Powiat tomaszowski - URBAN-RURAL GMINAS";15954;5862;10092;
0618011;"Tomaszów Lubelski (1)";17709;17709;0;
0618022;"Bełżec (2)";3082;0;3082;
0618032;"Jarczów (2)";3132;0;3132;
0618042;"Krynice (2)";2952;0;2952;
0618053;"Lubycza Królewska (3)";5488;2111;3377;
0618054;"Lubycza Królewska - urban area (4)";2111;2111;0;
0618055;"Lubycza Królewska - rural area (5)";3377;0;3377;
0618063;"Łaszczów (3)";5411;1944;3467;
0618064;"Łaszczów - urban area (4)";1944;1944;0;
0618065;"Łaszczów - rural area (5)";3467;0;3467;
0618072;"Rachanie (2)";4568;0;4568;
0618082;"Susiec (2)";6878;0;6878;
0618092;"Tarnawatka (2)";3750;0;3750;
0618102;"Telatyn (2)";3477;0;3477;
0618112;"Tomaszów Lubelski (2)";11081;0;11081;
0618123;"Tyszowce (3)";5055;1807;3248;
0618124;"Tyszowce - urban area (4)";1807;1807;0;
0618125;"Tyszowce - rural area (5)";3248;0;3248;
0618132;"Ulhówek (2)";3926;0;3926;
0619000;"Powiat włodawski";35186;12030;23156;
0619000;"Powiat włodawski - URBAN GMINAS";12030;12030;0;
0619011;"Włodawa (1)";12030;12030;0;
0619022;"Hanna (2)";2453;0;2453;
0619032;"Hańsk (2)";3368;0;3368;
0619042;"Stary Brus (2)";1791;0;1791;
0619052;"Urszulin (2)";4048;0;4048;
0619062;"Włodawa (2)";5734;0;5734;
0619072;"Wola Uhruska (2)";3583;0;3583;
0619082;"Wyryki (2)";2179;0;2179;
0620000;"Powiat zamojski";100368;10399;89969;
0620000;"Powiat zamojski - URBAN-RURAL GMINAS";23148;10399;12749;
0620012;"Adamów (2)";4399;0;4399;
0620022;"Grabowiec (2)";3544;0;3544;
0620032;"Komarów-Osada (2)";4402;0;4402;
0620043;"Krasnobród (3)";6639;2935;3704;
0620044;"Krasnobród - urban area (4)";2935;2935;0;
0620045;"Krasnobród - rural area (5)";3704;0;3704;
0620052;"Łabunie (2)";5862;0;5862;
0620062;"Miączyn (2)";4943;0;4943;
0620072;"Nielisz (2)";5052;0;5052;
0620082;"Radecznica (2)";5013;0;5013;
0620092;"Sitno (2)";6516;0;6516;
0620102;"Skierbieszów (2)";4690;0;4690;
0620112;"Stary Zamość (2)";4769;0;4769;
0620122;"Sułów (2)";4028;0;4028;
0620133;"Szczebrzeszyn (3)";10462;4703;5759;
0620134;"Szczebrzeszyn - urban area (4)";4703;4703;0;
0620135;"Szczebrzeszyn - rural area (5)";5759;0;5759;
0620142;"Zamość (2)";24002;0;24002;
0620153;"Zwierzyniec (3)";6047;2761;3286;
0620154;"Zwierzyniec - urban area (4)";2761;2761;0;
0620155;"Zwierzyniec - rural area (5)";3286;0;3286;
0661000;"City with powiat status Biała Podlaska";54178;54178;0;
0661000;"City with powiat status Biała Podlaska - URBAN GMINAS";54178;54178;0;
0661011;"Biała Podlaska (1)";54178;54178;0;
0662000;"City with powiat status Chełm";56832;56832;0;
0662000;"City with powiat status Chełm - URBAN GMINAS";56832;56832;0;
0662011;"Chełm (1)";56832;56832;0;
0663000;"City with powiat status Lublin";328868;328868;0;
0663000;"City with powiat status Lublin - URBAN GMINAS";328868;328868;0;
0663011;"Lublin (1)";328868;328868;0;
0664000;"City with powiat status Zamość";57924;57924;0;
0664000;"City with powiat status Zamość - URBAN GMINAS";57924;57924;0;
0664011;"Zamość (1)";57924;57924;0;
0801000;"Powiat gorzowski";74146;23953;50193;
0801000;"Powiat gorzowski - URBAN GMINAS";17536;17536;0;
0801000;"Powiat gorzowski - URBAN-RURAL GMINAS";12150;6417;5733;
0801011;"Kostrzyn nad Odrą (1)";17536;17536;0;
0801022;"Bogdaniec (2)";7191;0;7191;
0801032;"Deszczno (2)";11002;0;11002;
0801042;"Kłodawa (2)";9430;0;9430;
0801052;"Lubiszyn (2)";7183;0;7183;
0801062;"Santok (2)";9654;0;9654;
0801073;"Witnica (3)";12150;6417;5733;
0801074;"Witnica - urban area (4)";6417;6417;0;
0801075;"Witnica - rural area (5)";5733;0;5733;
0802000;"Powiat krośnieński";52461;25930;26531;
0802000;"Powiat krośnieński - URBAN GMINAS";15495;15495;0;
0802000;"Powiat krośnieński - URBAN-RURAL GMINAS";16822;10435;6387;
0802011;"Gubin (1)";15495;15495;0;
0802022;"Bobrowice (2)";3014;0;3014;
0802032;"Bytnica (2)";2271;0;2271;
0802042;"Dąbie (2)";4902;0;4902;
0802052;"Gubin (2)";7221;0;7221;
0802063;"Krosno Odrzańskie (3)";16822;10435;6387;
0802064;"Krosno Odrzańskie - urban area (4)";10435;10435;0;
0802065;"Krosno Odrzańskie - rural area (5)";6387;0;6387;
0802072;"Maszewo (2)";2736;0;2736;
0803000;"Powiat międzyrzecki";54584;27943;26641;
0803000;"Powiat międzyrzecki - URBAN-RURAL GMINAS";41256;27943;13313;
0803012;"Bledzew (2)";3873;0;3873;
0803023;"Międzyrzecz (3)";23572;16710;6862;
0803024;"Międzyrzecz - urban area (4)";16710;16710;0;
0803025;"Międzyrzecz - rural area (5)";6862;0;6862;
0803032;"Przytoczna (2)";5296;0;5296;
0803042;"Pszczew (2)";4159;0;4159;
0803053;"Skwierzyna (3)";11462;9020;2442;
0803054;"Skwierzyna - urban area (4)";9020;9020;0;
0803055;"Skwierzyna - rural area (5)";2442;0;2442;
0803063;"Trzciel (3)";6222;2213;4009;
0803064;"Trzciel - urban area (4)";2213;2213;0;
0803065;"Trzciel - rural area (5)";4009;0;4009;
0804000;"Powiat nowosolski";81989;52832;29157;
0804000;"Powiat nowosolski - URBAN GMINAS";35667;35667;0;
0804000;"Powiat nowosolski - URBAN-RURAL GMINAS";32403;17165;15238;
0804011;"Nowa Sól (1)";35667;35667;0;
0804023;"Bytom Odrzański (3)";5071;3880;1191;
0804024;"Bytom Odrzański - urban area (4)";3880;3880;0;
0804025;"Bytom Odrzański - rural area (5)";1191;0;1191;
0804032;"Kolsko (2)";3197;0;3197;
0804043;"Kożuchów (3)";15214;8879;6335;
0804044;"Kożuchów - urban area (4)";8879;8879;0;
0804045;"Kożuchów - rural area (5)";6335;0;6335;
0804052;"Nowa Sól (2)";7410;0;7410;
0804063;"Nowe Miasteczko (3)";5005;2622;2383;
0804064;"Nowe Miasteczko - urban area (4)";2622;2622;0;
0804065;"Nowe Miasteczko - rural area (5)";2383;0;2383;
0804073;"Otyń (3)";7113;1784;5329;
0804074;"Otyń - urban area (4)";1784;1784;0;
0804075;"Otyń - rural area (5)";5329;0;5329;
0804082;"Siedlisko (2)";3312;0;3312;
0805000;"Powiat słubicki";45740;29048;16692;
0805000;"Powiat słubicki - URBAN-RURAL GMINAS";41684;29048;12636;
0805013;"Cybinka (3)";6140;2654;3486;
0805014;"Cybinka - urban area (4)";2654;2654;0;
0805015;"Cybinka - rural area (5)";3486;0;3486;
0805022;"Górzyca (2)";4056;0;4056;
0805033;"Ośno Lubuskie (3)";6129;3870;2259;
0805034;"Ośno Lubuskie - urban area (4)";3870;3870;0;
0805035;"Ośno Lubuskie - rural area (5)";2259;0;2259;
0805043;"Rzepin (3)";9404;6355;3049;
0805044;"Rzepin - urban area (4)";6355;6355;0;
0805045;"Rzepin - rural area (5)";3049;0;3049;
0805053;"Słubice (3)";20011;16169;3842;
0805054;"Słubice - urban area (4)";16169;16169;0;
0805055;"Słubice - rural area (5)";3842;0;3842;
0806000;"Powiat strzelecko-drezdenecki";46446;22053;24393;
0806000;"Powiat strzelecko-drezdenecki - URBAN-RURAL GMINAS";38424;22053;16371;
0806013;"Dobiegniew (3)";6126;2970;3156;
0806014;"Dobiegniew - urban area (4)";2970;2970;0;
0806015;"Dobiegniew - rural area (5)";3156;0;3156;
0806023;"Drezdenko (3)";16246;9400;6846;
0806024;"Drezdenko - urban area (4)";9400;9400;0;
0806025;"Drezdenko - rural area (5)";6846;0;6846;
0806032;"Stare Kurowo (2)";3902;0;3902;
0806043;"Strzelce Krajeńskie (3)";16052;9683;6369;
0806044;"Strzelce Krajeńskie - urban area (4)";9683;9683;0;
0806045;"Strzelce Krajeńskie - rural area (5)";6369;0;6369;
0806052;"Zwierzyn (2)";4120;0;4120;
0807000;"Powiat sulęciński";33358;14051;19307;
0807000;"Powiat sulęciński - URBAN-RURAL GMINAS";24190;14051;10139;
0807012;"Krzeszyce (2)";4581;0;4581;
0807023;"Lubniewice (3)";3028;1999;1029;
0807024;"Lubniewice - urban area (4)";1999;1999;0;
0807025;"Lubniewice - rural area (5)";1029;0;1029;
0807032;"Słońsk (2)";4587;0;4587;
0807043;"Sulęcin (3)";14971;9675;5296;
0807044;"Sulęcin - urban area (4)";9675;9675;0;
0807045;"Sulęcin - rural area (5)";5296;0;5296;
0807053;"Torzym (3)";6191;2377;3814;
0807054;"Torzym - urban area (4)";2377;2377;0;
0807055;"Torzym - rural area (5)";3814;0;3814;
0808000;"Powiat świebodziński";53851;25605;28246;
0808000;"Powiat świebodziński - URBAN-RURAL GMINAS";36949;25605;11344;
0808012;"Lubrza (2)";3580;0;3580;
0808022;"Łagów (2)";4701;0;4701;
0808032;"Skąpe (2)";4992;0;4992;
0808042;"Szczaniec (2)";3629;0;3629;
0808053;"Świebodzin (3)";28909;20744;8165;
0808054;"Świebodzin - urban area (4)";20744;20744;0;
0808055;"Świebodzin - rural area (5)";8165;0;8165;
0808063;"Zbąszynek (3)";8040;4861;3179;
0808064;"Zbąszynek - urban area (4)";4861;4861;0;
0808065;"Zbąszynek - rural area (5)";3179;0;3179;
0809000;"Powiat zielonogórski";74980;31510;43470;
0809000;"Powiat zielonogórski - URBAN-RURAL GMINAS";57028;31510;25518;
0809013;"Babimost (3)";6057;3805;2252;
0809014;"Babimost - urban area (4)";3805;3805;0;
0809015;"Babimost - rural area (5)";2252;0;2252;
0809022;"Bojadła (2)";3137;0;3137;
0809033;"Czerwieńsk (3)";10153;3747;6406;
0809034;"Czerwieńsk - urban area (4)";3747;3747;0;
0809035;"Czerwieńsk - rural area (5)";6406;0;6406;
0809043;"Kargowa (3)";5925;3834;2091;
0809044;"Kargowa - urban area (4)";3834;3834;0;
0809045;"Kargowa - rural area (5)";2091;0;2091;
0809053;"Nowogród Bobrzański (3)";8950;4736;4214;
0809054;"Nowogród Bobrzański - urban area (4)";4736;4736;0;
0809055;"Nowogród Bobrzański - rural area (5)";4214;0;4214;
0809063;"Sulechów (3)";25943;15388;10555;
0809064;"Sulechów - urban area (4)";15388;15388;0;
0809065;"Sulechów - rural area (5)";10555;0;10555;
0809072;"Świdnica (2)";6918;0;6918;
0809082;"Trzebiechów (2)";3114;0;3114;
0809092;"Zabór (2)";4783;0;4783;
0810000;"Powiat żagański";73213;43409;29804;
0810000;"Powiat żagański - URBAN GMINAS";25975;25975;0;
0810000;"Powiat żagański - URBAN-RURAL GMINAS";30328;17434;12894;
0810011;"Gozdnica (1)";2692;2692;0;
0810021;"Żagań (1)";23283;23283;0;
0810032;"Brzeźnica (2)";3428;0;3428;
0810043;"Iłowa (3)";6324;3578;2746;
0810044;"Iłowa - urban area (4)";3578;3578;0;
0810045;"Iłowa - rural area (5)";2746;0;2746;
0810053;"Małomice (3)";5158;3402;1756;
0810054;"Małomice - urban area (4)";3402;3402;0;
0810055;"Małomice - rural area (5)";1756;0;1756;
0810062;"Niegosławice (2)";4253;0;4253;
0810073;"Szprotawa (3)";18846;10454;8392;
0810074;"Szprotawa - urban area (4)";10454;10454;0;
0810075;"Szprotawa - rural area (5)";8392;0;8392;
0810082;"Wymiarki (2)";2067;0;2067;
0810092;"Żagań (2)";7162;0;7162;
0811000;"Powiat żarski";90782;54435;36347;
0811000;"Powiat żarski - URBAN GMINAS";36808;36808;0;
0811000;"Powiat żarski - URBAN-RURAL GMINAS";26919;17627;9292;
0811011;"Łęknica (1)";2217;2217;0;
0811021;"Żary (1)";34591;34591;0;
0811033;"Brody (3)";3109;839;2270;
0811034;"Brody - urban area (4)";839;839;0;
0811035;"Brody - rural area (5)";2270;0;2270;
0811043;"Jasień (3)";6662;4008;2654;
0811044;"Jasień - urban area (4)";4008;4008;0;
0811045;"Jasień - rural area (5)";2654;0;2654;
0811052;"Lipinki Łużyckie (2)";3231;0;3231;
0811063;"Lubsko (3)";17148;12780;4368;
0811064;"Lubsko - urban area (4)";12780;12780;0;
0811065;"Lubsko - rural area (5)";4368;0;4368;
0811072;"Przewóz (2)";3003;0;3003;
0811082;"Trzebiel (2)";5435;0;5435;
0811092;"Tuplice (2)";2864;0;2864;
0811102;"Żary (2)";12522;0;12522;
0812000;"Powiat wschowski";37136;18250;18886;
0812000;"Powiat wschowski - URBAN-RURAL GMINAS";37136;18250;18886;
0812013;"Sława (3)";12414;4103;8311;
0812014;"Sława - urban area (4)";4103;4103;0;
0812015;"Sława - rural area (5)";8311;0;8311;
0812023;"Szlichtyngowa (3)";4802;1244;3558;
0812024;"Szlichtyngowa - urban area (4)";1244;1244;0;
0812025;"Szlichtyngowa - rural area (5)";3558;0;3558;
0812033;"Wschowa (3)";19920;12903;7017;
0812034;"Wschowa - urban area (4)";12903;12903;0;
0812035;"Wschowa - rural area (5)";7017;0;7017;
0861000;"City with powiat status Gorzów Wielkopolski";114567;114567;0;
0861000;"City with powiat status Gorzów Wielkopolski - URBAN GMINAS";114567;114567;0;
0861011;"Gorzów Wielkopolski (1)";114567;114567;0;
0862000;"City with powiat status Zielona Góra";138887;138887;0;
0862000;"City with powiat status Zielona Góra - URBAN GMINAS";138887;138887;0;
0862011;"Zielona Góra (1)";138887;138887;0;
1001000;"Powiat bełchatowski";108311;58926;49385;
1001000;"Powiat bełchatowski - URBAN GMINAS";51943;51943;0;
1001000;"Powiat bełchatowski - URBAN-RURAL GMINAS";14307;6983;7324;
1001011;"Bełchatów (1)";51943;51943;0;
1001022;"Bełchatów (2)";13224;0;13224;
1001032;"Drużbice (2)";5277;0;5277;
1001042;"Kleszczów (2)";6346;0;6346;
1001052;"Kluki (2)";4314;0;4314;
1001062;"Rusiec (2)";4760;0;4760;
1001072;"Szczerców (2)";8140;0;8140;
1001083;"Zelów (3)";14307;6983;7324;
1001084;"Zelów - urban area (4)";6983;6983;0;
1001085;"Zelów - rural area (5)";7324;0;7324;
1002000;"Powiat kutnowski";90128;52829;37299;
1002000;"Powiat kutnowski - URBAN GMINAS";40484;40484;0;
1002000;"Powiat kutnowski - URBAN-RURAL GMINAS";20227;12345;7882;
1002011;"Kutno (1)";40484;40484;0;
1002022;"Bedlno (2)";5025;0;5025;
1002033;"Dąbrowice (3)";1775;961;814;
1002034;"Dąbrowice - urban area (4)";961;961;0;
1002035;"Dąbrowice - rural area (5)";814;0;814;
1002043;"Krośniewice (3)";7655;3949;3706;
1002044;"Krośniewice - urban area (4)";3949;3949;0;
1002045;"Krośniewice - rural area (5)";3706;0;3706;
1002052;"Krzyżanów (2)";3993;0;3993;
1002062;"Kutno (2)";8938;0;8938;
1002072;"Łanięta (2)";2173;0;2173;
1002082;"Nowe Ostrowy (2)";3180;0;3180;
1002092;"Oporów (2)";2404;0;2404;
1002102;"Strzelce (2)";3704;0;3704;
1002113;"Żychlin (3)";10797;7435;3362;
1002114;"Żychlin - urban area (4)";7435;7435;0;
1002115;"Żychlin - rural area (5)";3362;0;3362;
1003000;"Powiat łaski";48622;15958;32664;
1003000;"Powiat łaski - URBAN-RURAL GMINAS";26843;15958;10885;
1003012;"Buczek (2)";5022;0;5022;
1003023;"Łask (3)";26843;15958;10885;
1003024;"Łask - urban area (4)";15958;15958;0;
1003025;"Łask - rural area (5)";10885;0;10885;
1003032;"Sędziejowice (2)";6167;0;6167;
1003042;"Widawa (2)";6824;0;6824;
1003052;"Wodzierady (2)";3766;0;3766;
1004000;"Powiat łęczycki";46452;15540;30912;
1004000;"Powiat łęczycki - URBAN GMINAS";12976;12976;0;
1004000;"Powiat łęczycki - URBAN-RURAL GMINAS";10857;2564;8293;
1004011;"Łęczyca (1)";12976;12976;0;
1004022;"Daszyna (2)";3599;0;3599;
1004032;"Góra Świętej Małgorzaty (2)";4240;0;4240;
1004043;"Grabów (3)";5287;1017;4270;
1004044;"Grabów - urban area (4)";1017;1017;0;
1004045;"Grabów - rural area (5)";4270;0;4270;
1004052;"Łęczyca (2)";8152;0;8152;
1004063;"Piątek (3)";5570;1547;4023;
1004064;"Piątek - urban area (4)";1547;1547;0;
1004065;"Piątek - rural area (5)";4023;0;4023;
1004072;"Świnice Warckie (2)";3623;0;3623;
1004082;"Witonia (2)";3005;0;3005;
1005000;"Powiat łowicki";73717;26600;47117;
1005000;"Powiat łowicki - URBAN GMINAS";25798;25798;0;
1005000;"Powiat łowicki - URBAN-RURAL GMINAS";3047;802;2245;
1005011;"Łowicz (1)";25798;25798;0;
1005022;"Bielawy (2)";4995;0;4995;
1005032;"Chąśno (2)";2879;0;2879;
1005042;"Domaniewice (2)";4526;0;4526;
1005053;"Kiernozia (3)";3047;802;2245;
1005054;"Kiernozia - urban area (4)";802;802;0;
1005055;"Kiernozia - rural area (5)";2245;0;2245;
1005062;"Kocierzew Południowy (2)";3954;0;3954;
1005072;"Łowicz (2)";7751;0;7751;
1005082;"Łyszkowice (2)";6394;0;6394;
1005092;"Nieborów (2)";9197;0;9197;
1005102;"Zduny (2)";5176;0;5176;
1006000;"Powiat łódzki wschodni";75008;22587;52421;
1006000;"Powiat łódzki wschodni - URBAN-RURAL GMINAS";47131;22587;24544;
1006022;"Andrespol (2)";14819;0;14819;
1006032;"Brójce (2)";7321;0;7321;
1006073;"Koluszki (3)";22765;11961;10804;
1006074;"Koluszki - urban area (4)";11961;11961;0;
1006075;"Koluszki - rural area (5)";10804;0;10804;
1006082;"Nowosolna (2)";5737;0;5737;
1006103;"Rzgów (3)";11512;3455;8057;
1006104;"Rzgów - urban area (4)";3455;3455;0;
1006105;"Rzgów - rural area (5)";8057;0;8057;
1006113;"Tuszyn (3)";12854;7171;5683;
1006114;"Tuszyn - urban area (4)";7171;7171;0;
1006115;"Tuszyn - rural area (5)";5683;0;5683;
1007000;"Powiat opoczyński";71452;24436;47016;
1007000;"Powiat opoczyński - URBAN-RURAL GMINAS";52241;24436;27805;
1007013;"Białaczów (3)";5480;1084;4396;
1007014;"Białaczów - urban area (4)";1084;1084;0;
1007015;"Białaczów - rural area (5)";4396;0;4396;
1007023;"Drzewica (3)";9727;3492;6235;
1007024;"Drzewica - urban area (4)";3492;3492;0;
1007025;"Drzewica - rural area (5)";6235;0;6235;
1007032;"Mniszków (2)";4699;0;4699;
1007043;"Opoczno (3)";31500;18759;12741;
1007044;"Opoczno - urban area (4)";18759;18759;0;
1007045;"Opoczno - rural area (5)";12741;0;12741;
1007052;"Paradyż (2)";4170;0;4170;
1007062;"Poświętne (2)";2876;0;2876;
1007072;"Sławno (2)";7466;0;7466;
1007083;"Żarnów (3)";5534;1101;4433;
1007084;"Żarnów - urban area (4)";1101;1101;0;
1007085;"Żarnów - rural area (5)";4433;0;4433;
1008000;"Powiat pabianicki";119037;81160;37877;
1008000;"Powiat pabianicki - URBAN GMINAS";79573;79573;0;
1008000;"Powiat pabianicki - URBAN-RURAL GMINAS";9588;1587;8001;
1008011;"Konstantynów Łódzki (1)";19305;19305;0;
1008021;"Pabianice (1)";60268;60268;0;
1008032;"Dłutów (2)";4982;0;4982;
1008042;"Dobroń (2)";8136;0;8136;
1008052;"Ksawerów (2)";7704;0;7704;
1008063;"Lutomiersk (3)";9588;1587;8001;
1008064;"Lutomiersk - urban area (4)";1587;1587;0;
1008065;"Lutomiersk - rural area (5)";8001;0;8001;
1008072;"Pabianice (2)";9054;0;9054;
1009000;"Powiat pajęczański";48345;11549;36796;
1009000;"Powiat pajęczański - URBAN-RURAL GMINAS";22463;11549;10914;
1009013;"Działoszyn (3)";11438;5212;6226;
1009014;"Działoszyn - urban area (4)";5212;5212;0;
1009015;"Działoszyn - rural area (5)";6226;0;6226;
1009022;"Kiełczygłów (2)";3741;0;3741;
1009032;"Nowa Brzeźnica (2)";4305;0;4305;
1009043;"Pajęczno (3)";11025;6337;4688;
1009044;"Pajęczno - urban area (4)";6337;6337;0;
1009045;"Pajęczno - rural area (5)";4688;0;4688;
1009052;"Rząśnia (2)";4893;0;4893;
1009062;"Siemkowice (2)";4411;0;4411;
1009072;"Strzelce Wielkie (2)";4136;0;4136;
1009082;"Sulmierzyce (2)";4396;0;4396;
1010000;"Powiat piotrkowski";89945;9789;80156;
1010000;"Powiat piotrkowski - URBAN-RURAL GMINAS";36557;9789;26768;
1010012;"Aleksandrów (2)";4207;0;4207;
1010022;"Czarnocin (2)";4028;0;4028;
1010032;"Gorzkowice (2)";8177;0;8177;
1010042;"Grabica (2)";6061;0;6061;
1010052;"Łęki Szlacheckie (2)";3170;0;3170;
1010062;"Moszczenica (2)";12549;0;12549;
1010072;"Ręczno (2)";3314;0;3314;
1010083;"Rozprza (3)";12185;1627;10558;
1010084;"Rozprza - urban area (4)";1627;1627;0;
1010085;"Rozprza - rural area (5)";10558;0;10558;
1010093;"Sulejów (3)";16546;5896;10650;
1010094;"Sulejów - urban area (4)";5896;5896;0;
1010095;"Sulejów - rural area (5)";10650;0;10650;
1010102;"Wola Krzysztoporska (2)";11882;0;11882;
1010113;"Wolbórz (3)";7826;2266;5560;
1010114;"Wolbórz - urban area (4)";2266;2266;0;
1010115;"Wolbórz - rural area (5)";5560;0;5560;
1011000;"Powiat poddębicki";39267;9708;29559;
1011000;"Powiat poddębicki - URBAN-RURAL GMINAS";21194;9708;11486;
1011012;"Dalików (2)";4033;0;4033;
1011022;"Pęczniew (2)";3338;0;3338;
1011033;"Poddębice (3)";14470;6720;7750;
1011034;"Poddębice - urban area (4)";6720;6720;0;
1011035;"Poddębice - rural area (5)";7750;0;7750;
1011043;"Uniejów (3)";6724;2988;3736;
1011044;"Uniejów - urban area (4)";2988;2988;0;
1011045;"Uniejów - rural area (5)";3736;0;3736;
1011052;"Wartkowice (2)";6066;0;6066;
1011062;"Zadzim (2)";4636;0;4636;
1012000;"Powiat radomszczański";106173;48474;57699;
1012000;"Powiat radomszczański - URBAN GMINAS";42718;42718;0;
1012000;"Powiat radomszczański - URBAN-RURAL GMINAS";12033;5756;6277;
1012011;"Radomsko (1)";42718;42718;0;
1012022;"Dobryszyce (2)";4615;0;4615;
1012032;"Gidle (2)";5717;0;5717;
1012042;"Gomunice (2)";5607;0;5607;
1012053;"Kamieńsk (3)";5527;2599;2928;
1012054;"Kamieńsk - urban area (4)";2599;2599;0;
1012055;"Kamieńsk - rural area (5)";2928;0;2928;
1012062;"Kobiele Wielkie (2)";4222;0;4222;
1012072;"Kodrąb (2)";4234;0;4234;
1012082;"Lgota Wielka (2)";4125;0;4125;
1012092;"Ładzice (2)";4589;0;4589;
1012102;"Masłowice (2)";3868;0;3868;
1012113;"Przedbórz (3)";6506;3157;3349;
1012114;"Przedbórz - urban area (4)";3157;3157;0;
1012115;"Przedbórz - rural area (5)";3349;0;3349;
1012122;"Radomsko (2)";5410;0;5410;
1012132;"Wielgomłyny (2)";4269;0;4269;
1012142;"Żytno (2)";4766;0;4766;
1013000;"Powiat rawski";45925;18856;27069;
1013000;"Powiat rawski - URBAN GMINAS";15884;15884;0;
1013000;"Powiat rawski - URBAN-RURAL GMINAS";10706;2972;7734;
1013011;"Rawa Mazowiecka (1)";15884;15884;0;
1013023;"Biała Rawska (3)";10706;2972;7734;
1013024;"Biała Rawska - urban area (4)";2972;2972;0;
1013025;"Biała Rawska - rural area (5)";7734;0;7734;
1013032;"Cielądz (2)";3904;0;3904;
1013042;"Rawa Mazowiecka (2)";8642;0;8642;
1013052;"Regnów (2)";1701;0;1701;
1013062;"Sadkowice (2)";5088;0;5088;
1014000;"Powiat sieradzki";111022;46771;64251;
1014000;"Powiat sieradzki - URBAN GMINAS";38458;38458;0;
1014000;"Powiat sieradzki - URBAN-RURAL GMINAS";32429;8313;24116;
1014011;"Sieradz (1)";38458;38458;0;
1014023;"Błaszki (3)";13880;1975;11905;
1014024;"Błaszki - urban area (4)";1975;1975;0;
1014025;"Błaszki - rural area (5)";11905;0;11905;
1014032;"Brąszewice (2)";4311;0;4311;
1014042;"Brzeźnio (2)";6138;0;6138;
1014052;"Burzenin (2)";5243;0;5243;
1014062;"Goszczanów (2)";5025;0;5025;
1014072;"Klonowa (2)";2722;0;2722;
1014082;"Sieradz (2)";10818;0;10818;
1014093;"Warta (3)";11776;2923;8853;
1014094;"Warta - urban area (4)";2923;2923;0;
1014095;"Warta - rural area (5)";8853;0;8853;
1014102;"Wróblew (2)";5878;0;5878;
1014113;"Złoczew (3)";6773;3415;3358;
1014114;"Złoczew - urban area (4)";3415;3415;0;
1014115;"Złoczew - rural area (5)";3358;0;3358;
1015000;"Powiat skierniewicki";37733;895;36838;
1015000;"Powiat skierniewicki - URBAN-RURAL GMINAS";3869;895;2974;
1015013;"Bolimów (3)";3869;895;2974;
1015014;"Bolimów - urban area (4)";895;895;0;
1015015;"Bolimów - rural area (5)";2974;0;2974;
1015022;"Głuchów (2)";5439;0;5439;
1015032;"Godzianów (2)";2551;0;2551;
1015042;"Kowiesy (2)";2764;0;2764;
1015052;"Lipce Reymontowskie (2)";3078;0;3078;
1015062;"Maków (2)";5946;0;5946;
1015072;"Nowy Kawęczyn (2)";3432;0;3432;
1015082;"Skierniewice (2)";8170;0;8170;
1015092;"Słupia (2)";2484;0;2484;
1016000;"Powiat tomaszowski";110086;59277;50809;
1016000;"Powiat tomaszowski - URBAN GMINAS";57016;57016;0;
1016000;"Powiat tomaszowski - URBAN-RURAL GMINAS";10938;2261;8677;
1016011;"Tomaszów Mazowiecki (1)";57016;57016;0;
1016022;"Będków (2)";3129;0;3129;
1016032;"Budziszewice (2)";2070;0;2070;
1016042;"Czerniewice (2)";4788;0;4788;
1016053;"Inowłódz (3)";3638;744;2894;
1016054;"Inowłódz - urban area (4)";744;744;0;
1016055;"Inowłódz - rural area (5)";2894;0;2894;
1016062;"Lubochnia (2)";7166;0;7166;
1016072;"Rokiciny (2)";6053;0;6053;
1016082;"Rzeczyca (2)";4377;0;4377;
1016092;"Tomaszów Mazowiecki (2)";11467;0;11467;
1016103;"Ujazd (3)";7300;1517;5783;
1016104;"Ujazd - urban area (4)";1517;1517;0;
1016105;"Ujazd - rural area (5)";5783;0;5783;
1016112;"Żelechlinek (2)";3082;0;3082;
1017000;"Powiat wieluński";72246;21608;50638;
1017000;"Powiat wieluński - URBAN-RURAL GMINAS";34000;21608;12392;
1017012;"Biała (2)";5276;0;5276;
1017022;"Czarnożyły (2)";4352;0;4352;
1017032;"Konopnica (2)";3537;0;3537;
1017042;"Mokrsko (2)";5041;0;5041;
1017053;"Osjaków (3)";4625;1326;3299;
1017054;"Osjaków - urban area (4)";1326;1326;0;
1017055;"Osjaków - rural area (5)";3299;0;3299;
1017062;"Ostrówek (2)";4354;0;4354;
1017072;"Pątnów (2)";6145;0;6145;
1017082;"Skomlin (2)";3175;0;3175;
1017093;"Wieluń (3)";29375;20282;9093;
1017094;"Wieluń - urban area (4)";20282;20282;0;
1017095;"Wieluń - rural area (5)";9093;0;9093;
1017102;"Wierzchlas (2)";6366;0;6366;
1018000;"Powiat wieruszowski";41417;11333;30084;
1018000;"Powiat wieruszowski - URBAN-RURAL GMINAS";22414;11333;11081;
1018013;"Bolesławiec (3)";3849;880;2969;
1018014;"Bolesławiec - urban area (4)";880;880;0;
1018015;"Bolesławiec - rural area (5)";2969;0;2969;
1018022;"Czastary (2)";3895;0;3895;
1018032;"Galewice (2)";6125;0;6125;
1018043;"Lututów (3)";4542;2187;2355;
1018044;"Lututów - urban area (4)";2187;2187;0;
1018045;"Lututów - rural area (5)";2355;0;2355;
1018052;"Łubnice (2)";3837;0;3837;
1018062;"Sokolniki (2)";5146;0;5146;
1018073;"Wieruszów (3)";14023;8266;5757;
1018074;"Wieruszów - urban area (4)";8266;8266;0;
1018075;"Wieruszów - rural area (5)";5757;0;5757;
1019000;"Powiat zduńskowolski";63059;39871;23188;
1019000;"Powiat zduńskowolski - URBAN GMINAS";38126;38126;0;
1019000;"Powiat zduńskowolski - URBAN-RURAL GMINAS";7025;1745;5280;
1019011;"Zduńska Wola (1)";38126;38126;0;
1019023;"Szadek (3)";7025;1745;5280;
1019024;"Szadek - urban area (4)";1745;1745;0;
1019025;"Szadek - rural area (5)";5280;0;5280;
1019032;"Zapolice (2)";5508;0;5508;
1019042;"Zduńska Wola (2)";12400;0;12400;
1020000;"Powiat zgierski";166190;110552;55638;
1020000;"Powiat zgierski - URBAN GMINAS";84252;84252;0;
1020000;"Powiat zgierski - URBAN-RURAL GMINAS";53626;26300;27326;
1020011;"Głowno (1)";13022;13022;0;
1020021;"Ozorków (1)";17969;17969;0;
1020031;"Zgierz (1)";53261;53261;0;
1020043;"Aleksandrów Łódzki (3)";35332;22030;13302;
1020044;"Aleksandrów Łódzki - urban area (4)";22030;22030;0;
1020045;"Aleksandrów Łódzki - rural area (5)";13302;0;13302;
1020052;"Głowno (2)";4620;0;4620;
1020062;"Ozorków (2)";7276;0;7276;
1020073;"Parzęczew (3)";5294;933;4361;
1020074;"Parzęczew - urban area (4)";933;933;0;
1020075;"Parzęczew - rural area (5)";4361;0;4361;
1020083;"Stryków (3)";13000;3337;9663;
1020084;"Stryków - urban area (4)";3337;3337;0;
1020085;"Stryków - rural area (5)";9663;0;9663;
1020092;"Zgierz (2)";16416;0;16416;
1021000;"Powiat brzeziński";30102;13156;16946;
1021000;"Powiat brzeziński - URBAN GMINAS";11902;11902;0;
1021000;"Powiat brzeziński - URBAN-RURAL GMINAS";3132;1254;1878;
1021011;"Brzeziny (1)";11902;11902;0;
1021022;"Brzeziny (2)";6158;0;6158;
1021032;"Dmosin (2)";4343;0;4343;
1021043;"Jeżów (3)";3132;1254;1878;
1021044;"Jeżów - urban area (4)";1254;1254;0;
1021045;"Jeżów - rural area (5)";1878;0;1878;
1021052;"Rogów (2)";4567;0;4567;
1061000;"City with powiat status Łódź";648711;648711;0;
1061000;"City with powiat status Łódź - URBAN GMINAS";648711;648711;0;
1061011;"Łódź (1)";648711;648711;0;
1062000;"City with powiat status Piotrków Trybunalski";66211;66211;0;
1062000;"City with powiat status Piotrków Trybunalski - URBAN GMINAS";66211;66211;0;
1062011;"Piotrków Trybunalski (1)";66211;66211;0;
1063000;"City with powiat status Skierniewice";44976;44976;0;
1063000;"City with powiat status Skierniewice - URBAN GMINAS";44976;44976;0;
1063011;"Skierniewice (1)";44976;44976;0;
1201000;"Powiat bocheński";106911;31093;75818;
1201000;"Powiat bocheński - URBAN GMINAS";28369;28369;0;
1201000;"Powiat bocheński - URBAN-RURAL GMINAS";14461;2724;11737;
1201011;"Bochnia (1)";28369;28369;0;
1201022;"Bochnia (2)";20857;0;20857;
1201032;"Drwinia (2)";6375;0;6375;
1201042;"Lipnica Murowana (2)";5508;0;5508;
1201052;"Łapanów (2)";8614;0;8614;
1201063;"Nowy Wiśnicz (3)";14461;2724;11737;
1201064;"Nowy Wiśnicz - urban area (4)";2724;2724;0;
1201065;"Nowy Wiśnicz - rural area (5)";11737;0;11737;
1201072;"Rzezawa (2)";11487;0;11487;
1201082;"Trzciana (2)";5713;0;5713;
1201092;"Żegocina (2)";5527;0;5527;
1202000;"Powiat brzeski";91497;18112;73385;
1202000;"Powiat brzeski - URBAN-RURAL GMINAS";45053;18112;26941;
1202012;"Borzęcin (2)";8117;0;8117;
1202023;"Brzesko (3)";35354;15833;19521;
1202024;"Brzesko - urban area (4)";15833;15833;0;
1202025;"Brzesko - rural area (5)";19521;0;19521;
1202033;"Czchów (3)";9699;2279;7420;
1202034;"Czchów - urban area (4)";2279;2279;0;
1202035;"Czchów - rural area (5)";7420;0;7420;
1202042;"Dębno (2)";14498;0;14498;
1202052;"Gnojnik (2)";8099;0;8099;
1202062;"Iwkowa (2)";6650;0;6650;
1202072;"Szczurowa (2)";9080;0;9080;
1203000;"Powiat chrzanowski";118194;71186;47008;
1203000;"Powiat chrzanowski - URBAN-RURAL GMINAS";109206;71186;38020;
1203013;"Alwernia (3)";12330;3232;9098;
1203014;"Alwernia - urban area (4)";3232;3232;0;
1203015;"Alwernia - rural area (5)";9098;0;9098;
1203022;"Babice (2)";8988;0;8988;
1203033;"Chrzanów (3)";43704;33707;9997;
1203034;"Chrzanów - urban area (4)";33707;33707;0;
1203035;"Chrzanów - rural area (5)";9997;0;9997;
1203043;"Libiąż (3)";20978;15842;5136;
1203044;"Libiąż - urban area (4)";15842;15842;0;
1203045;"Libiąż - rural area (5)";5136;0;5136;
1203053;"Trzebinia (3)";32194;18405;13789;
1203054;"Trzebinia - urban area (4)";18405;18405;0;
1203055;"Trzebinia - rural area (5)";13789;0;13789;
1204000;"Powiat dąbrowski";57390;15482;41908;
1204000;"Powiat dąbrowski - URBAN-RURAL GMINAS";33275;15482;17793;
1204012;"Bolesław (2)";2640;0;2640;
1204023;"Dąbrowa Tarnowska (3)";20883;11409;9474;
1204024;"Dąbrowa Tarnowska - urban area (4)";11409;11409;0;
1204025;"Dąbrowa Tarnowska - rural area (5)";9474;0;9474;
1204032;"Gręboszów (2)";3147;0;3147;
1204042;"Mędrzechów (2)";3269;0;3269;
1204052;"Olesno (2)";7627;0;7627;
1204062;"Radgoszcz (2)";7432;0;7432;
1204073;"Szczucin (3)";12392;4073;8319;
1204074;"Szczucin - urban area (4)";4073;4073;0;
1204075;"Szczucin - rural area (5)";8319;0;8319;
1205000;"Powiat gorlicki";104927;32710;72217;
1205000;"Powiat gorlicki - URBAN GMINAS";25367;25367;0;
1205000;"Powiat gorlicki - URBAN-RURAL GMINAS";25622;7343;18279;
1205011;"Gorlice (1)";25367;25367;0;
1205023;"Biecz (3)";16016;4290;11726;
1205024;"Biecz - urban area (4)";4290;4290;0;
1205025;"Biecz - rural area (5)";11726;0;11726;
1205033;"Bobowa (3)";9606;3053;6553;
1205034;"Bobowa - urban area (4)";3053;3053;0;
1205035;"Bobowa - rural area (5)";6553;0;6553;
1205042;"Gorlice (2)";16906;0;16906;
1205052;"Lipinki (2)";6661;0;6661;
1205062;"Łużna (2)";8285;0;8285;
1205072;"Moszczenica (2)";4897;0;4897;
1205082;"Ropa (2)";5509;0;5509;
1205092;"Sękowa (2)";4909;0;4909;
1205102;"Uście Gorlickie (2)";6771;0;6771;
1206000;"Powiat krakowski";303577;44102;259475;
1206000;"Powiat krakowski - URBAN-RURAL GMINAS";111636;44102;67534;
1206012;"Czernichów (2)";15453;0;15453;
1206022;"Igołomia-Wawrzeńczyce (2)";7851;0;7851;
1206032;"Iwanowice (2)";9843;0;9843;
1206042;"Jerzmanowice-Przeginia (2)";11170;0;11170;
1206052;"Kocmyrzów-Luborzyca (2)";18516;0;18516;
1206063;"Krzeszowice (3)";31844;9755;22089;
1206064;"Krzeszowice - urban area (4)";9755;9755;0;
1206065;"Krzeszowice - rural area (5)";22089;0;22089;
1206072;"Liszki (2)";18690;0;18690;
1206082;"Michałowice (2)";13507;0;13507;
1206092;"Mogilany (2)";16406;0;16406;
1206103;"Skała (3)";10957;3872;7085;
1206104;"Skała - urban area (4)";3872;3872;0;
1206105;"Skała - rural area (5)";7085;0;7085;
1206113;"Skawina (3)";43990;23919;20071;
1206114;"Skawina - urban area (4)";23919;23919;0;
1206115;"Skawina - rural area (5)";20071;0;20071;
1206123;"Słomniki (3)";13671;4171;9500;
1206124;"Słomniki - urban area (4)";4171;4171;0;
1206125;"Słomniki - rural area (5)";9500;0;9500;
1206132;"Sułoszowa (2)";5651;0;5651;
1206143;"Świątniki Górne (3)";11174;2385;8789;
1206144;"Świątniki Górne - urban area (4)";2385;2385;0;
1206145;"Świątniki Górne - rural area (5)";8789;0;8789;
1206152;"Wielka Wieś (2)";17171;0;17171;
1206162;"Zabierzów (2)";29718;0;29718;
1206172;"Zielonki (2)";27965;0;27965;
1207000;"Powiat limanowski";131765;22254;109511;
1207000;"Powiat limanowski - URBAN GMINAS";22254;22254;0;
1207011;"Limanowa (1)";14437;14437;0;
1207021;"Mszana Dolna (1)";7817;7817;0;
1207032;"Dobra (2)";10109;0;10109;
1207042;"Jodłownik (2)";8792;0;8792;
1207052;"Kamienica (2)";7795;0;7795;
1207062;"Laskowa (2)";8190;0;8190;
1207072;"Limanowa (2)";26118;0;26118;
1207082;"Łukowica (2)";10184;0;10184;
1207092;"Mszana Dolna (2)";17652;0;17652;
1207102;"Niedźwiedź (2)";7282;0;7282;
1207112;"Słopnice (2)";7027;0;7027;
1207122;"Tymbark (2)";6362;0;6362;
1208000;"Powiat miechowski";46523;11749;34774;
1208000;"Powiat miechowski - URBAN-RURAL GMINAS";23456;11749;11707;
1208012;"Charsznica (2)";7038;0;7038;
1208022;"Gołcza (2)";5907;0;5907;
1208032;"Kozłów (2)";4403;0;4403;
1208043;"Książ Wielki (3)";4816;846;3970;
1208044;"Książ Wielki - urban area (4)";846;846;0;
1208045;"Książ Wielki - rural area (5)";3970;0;3970;
1208053;"Miechów (3)";18640;10903;7737;
1208054;"Miechów - urban area (4)";10903;10903;0;
1208055;"Miechów - rural area (5)";7737;0;7737;
1208062;"Racławice (2)";2426;0;2426;
1208072;"Słaboszów (2)";3293;0;3293;
1209000;"Powiat myślenicki";130028;30342;99686;
1209000;"Powiat myślenicki - URBAN-RURAL GMINAS";76386;30342;46044;
1209013;"Dobczyce (3)";15536;6134;9402;
1209014;"Dobczyce - urban area (4)";6134;6134;0;
1209015;"Dobczyce - rural area (5)";9402;0;9402;
1209022;"Lubień (2)";10109;0;10109;
1209033;"Myślenice (3)";45618;17720;27898;
1209034;"Myślenice - urban area (4)";17720;17720;0;
1209035;"Myślenice - rural area (5)";27898;0;27898;
1209042;"Pcim (2)";11091;0;11091;
1209052;"Raciechowice (2)";6444;0;6444;
1209062;"Siepraw (2)";9667;0;9667;
1209073;"Sułkowice (3)";15232;6488;8744;
1209074;"Sułkowice - urban area (4)";6488;6488;0;
1209075;"Sułkowice - rural area (5)";8744;0;8744;
1209082;"Tokarnia (2)";8789;0;8789;
1209092;"Wiśniowa (2)";7542;0;7542;
1210000;"Powiat nowosądecki";215039;33872;181167;
1210000;"Powiat nowosądecki - URBAN GMINAS";5928;5928;0;
1210000;"Powiat nowosądecki - URBAN-RURAL GMINAS";60027;27944;32083;
1210011;"Grybów (1)";5928;5928;0;
1210022;"Chełmiec (2)";29811;0;29811;
1210032;"Gródek nad Dunajcem (2)";8909;0;8909;
1210042;"Grybów (2)";25344;0;25344;
1210052;"Kamionka Wielka (2)";10496;0;10496;
1210062;"Korzenna (2)";14445;0;14445;
1210073;"Krynica-Zdrój (3)";15521;9504;6017;
1210074;"Krynica-Zdrój - urban area (4)";9504;9504;0;
1210075;"Krynica-Zdrój - rural area (5)";6017;0;6017;
1210082;"Łabowa (2)";6034;0;6034;
1210092;"Łącko (2)";16670;0;16670;
1210102;"Łososina Dolna (2)";11211;0;11211;
1210113;"Muszyna (3)";11103;4432;6671;
1210114;"Muszyna - urban area (4)";4432;4432;0;
1210115;"Muszyna - rural area (5)";6671;0;6671;
1210122;"Nawojowa (2)";8883;0;8883;
1210133;"Piwniczna-Zdrój (3)";9905;5362;4543;
1210134;"Piwniczna-Zdrój - urban area (4)";5362;5362;0;
1210135;"Piwniczna-Zdrój - rural area (5)";4543;0;4543;
1210142;"Podegrodzie (2)";13640;0;13640;
1210152;"Rytro (2)";3641;0;3641;
1210163;"Stary Sącz (3)";23498;8646;14852;
1210164;"Stary Sącz - urban area (4)";8646;8646;0;
1210165;"Stary Sącz - rural area (5)";14852;0;14852;
1211000;"Powiat nowotarski";190116;54124;135992;
1211000;"Powiat nowotarski - URBAN GMINAS";33073;33073;0;
1211000;"Powiat nowotarski - URBAN-RURAL GMINAS";45268;21051;24217;
1211011;"Nowy Targ (1)";33073;33073;0;
1211023;"Szczawnica (3)";6623;5188;1435;
1211024;"Szczawnica - urban area (4)";5188;5188;0;
1211025;"Szczawnica - rural area (5)";1435;0;1435;
1211033;"Czarny Dunajec (3)";22160;3677;18483;
1211034;"Czarny Dunajec - urban area (4)";3677;3677;0;
1211035;"Czarny Dunajec - rural area (5)";18483;0;18483;
1211042;"Czorsztyn (2)";7581;0;7581;
1211052;"Jabłonka (2)";19195;0;19195;
1211062;"Krościenko nad Dunajcem (2)";6630;0;6630;
1211072;"Lipnica Wielka (2)";6056;0;6056;
1211082;"Łapsze Niżne (2)";9252;0;9252;
1211092;"Nowy Targ (2)";24043;0;24043;
1211102;"Ochotnica Dolna (2)";8499;0;8499;
1211112;"Raba Wyżna (2)";14464;0;14464;
1211123;"Rabka-Zdrój (3)";16485;12186;4299;
1211124;"Rabka-Zdrój - urban area (4)";12186;12186;0;
1211125;"Rabka-Zdrój - rural area (5)";4299;0;4299;
1211132;"Spytkowice (2)";4719;0;4719;
1211142;"Szaflary (2)";11336;0;11336;
1212000;"Powiat olkuski";105385;49408;55977;
1212000;"Powiat olkuski - URBAN GMINAS";9362;9362;0;
1212000;"Powiat olkuski - URBAN-RURAL GMINAS";67184;40046;27138;
1212011;"Bukowno (1)";9362;9362;0;
1212032;"Bolesław (2)";7516;0;7516;
1212042;"Klucze (2)";14399;0;14399;
1212053;"Olkusz (3)";45413;32048;13365;
1212054;"Olkusz - urban area (4)";32048;32048;0;
1212055;"Olkusz - rural area (5)";13365;0;13365;
1212062;"Trzyciąż (2)";6924;0;6924;
1212073;"Wolbrom (3)";21771;7998;13773;
1212074;"Wolbrom - urban area (4)";7998;7998;0;
1212075;"Wolbrom - rural area (5)";13773;0;13773;
1213000;"Powiat oświęcimski";148042;75575;72467;
1213000;"Powiat oświęcimski - URBAN GMINAS";35420;35420;0;
1213000;"Powiat oświęcimski - URBAN-RURAL GMINAS";74911;40155;34756;
1213011;"Oświęcim (1)";35420;35420;0;
1213023;"Brzeszcze (3)";20306;10578;9728;
1213024;"Brzeszcze - urban area (4)";10578;10578;0;
1213025;"Brzeszcze - rural area (5)";9728;0;9728;
1213033;"Chełmek (3)";12283;8376;3907;
1213034;"Chełmek - urban area (4)";8376;8376;0;
1213035;"Chełmek - rural area (5)";3907;0;3907;
1213043;"Kęty (3)";33240;17619;15621;
1213044;"Kęty - urban area (4)";17619;17619;0;
1213045;"Kęty - rural area (5)";15621;0;15621;
1213052;"Osiek (2)";8112;0;8112;
1213062;"Oświęcim (2)";18971;0;18971;
1213072;"Polanka Wielka (2)";4300;0;4300;
1213082;"Przeciszów (2)";6328;0;6328;
1213093;"Zator (3)";9082;3582;5500;
1213094;"Zator - urban area (4)";3582;3582;0;
1213095;"Zator - rural area (5)";5500;0;5500;
1214000;"Powiat proszowicki";41940;8088;33852;
1214000;"Powiat proszowicki - URBAN-RURAL GMINAS";26257;8088;18169;
1214012;"Koniusza (2)";9078;0;9078;
1214023;"Koszyce (3)";5212;759;4453;
1214024;"Koszyce - urban area (4)";759;759;0;
1214025;"Koszyce - rural area (5)";4453;0;4453;
1214033;"Nowe Brzesko (3)";5625;1603;4022;
1214034;"Nowe Brzesko - urban area (4)";1603;1603;0;
1214035;"Nowe Brzesko - rural area (5)";4022;0;4022;
1214042;"Pałecznica (2)";3436;0;3436;
1214053;"Proszowice (3)";15420;5726;9694;
1214054;"Proszowice - urban area (4)";5726;5726;0;
1214055;"Proszowice - rural area (5)";9694;0;9694;
1214062;"Radziemice (2)";3169;0;3169;
1215000;"Powiat suski";82738;19700;63038;
1215000;"Powiat suski - URBAN GMINAS";14190;14190;0;
1215000;"Powiat suski - URBAN-RURAL GMINAS";15693;5510;10183;
1215011;"Jordanów (1)";5389;5389;0;
1215021;"Sucha Beskidzka (1)";8801;8801;0;
1215032;"Budzów (2)";8818;0;8818;
1215042;"Bystra-Sidzina (2)";6811;0;6811;
1215052;"Jordanów (2)";11186;0;11186;
1215063;"Maków Podhalański (3)";15693;5510;10183;
1215064;"Maków Podhalański - urban area (4)";5510;5510;0;
1215065;"Maków Podhalański - rural area (5)";10183;0;10183;
1215072;"Stryszawa (2)";11865;0;11865;
1215082;"Zawoja (2)";8774;0;8774;
1215092;"Zembrzyce (2)";5401;0;5401;
1216000;"Powiat tarnowski";197235;22783;174452;
1216000;"Powiat tarnowski - URBAN-RURAL GMINAS";92282;22783;69499;
1216013;"Ciężkowice (3)";10987;2475;8512;
1216014;"Ciężkowice - urban area (4)";2475;2475;0;
1216015;"Ciężkowice - rural area (5)";8512;0;8512;
1216022;"Gromnik (2)";8737;0;8737;
1216032;"Lisia Góra (2)";15655;0;15655;
1216042;"Pleśna (2)";11740;0;11740;
1216053;"Radłów (3)";9398;2707;6691;
1216054;"Radłów - urban area (4)";2707;2707;0;
1216055;"Radłów - rural area (5)";6691;0;6691;
1216063;"Ryglice (3)";11165;2660;8505;
1216064;"Ryglice - urban area (4)";2660;2660;0;
1216065;"Ryglice - rural area (5)";8505;0;8505;
1216072;"Rzepiennik Strzyżewski (2)";6505;0;6505;
1216082;"Skrzyszów (2)";14180;0;14180;
1216092;"Tarnów (2)";26483;0;26483;
1216103;"Tuchów (3)";16949;6149;10800;
1216104;"Tuchów - urban area (4)";6149;6149;0;
1216105;"Tuchów - rural area (5)";10800;0;10800;
1216112;"Wierzchosławice (2)";10465;0;10465;
1216122;"Wietrzychowice (2)";3697;0;3697;
1216133;"Wojnicz (3)";13082;3134;9948;
1216134;"Wojnicz - urban area (4)";3134;3134;0;
1216135;"Wojnicz - rural area (5)";9948;0;9948;
1216143;"Zakliczyn (3)";12356;1583;10773;
1216144;"Zakliczyn - urban area (4)";1583;1583;0;
1216145;"Zakliczyn - rural area (5)";10773;0;10773;
1216153;"Żabno (3)";18345;4075;14270;
1216154;"Żabno - urban area (4)";4075;4075;0;
1216155;"Żabno - rural area (5)";14270;0;14270;
1216162;"Szerzyny (2)";7491;0;7491;
1217000;"Powiat tatrzański";66375;25100;41275;
1217000;"Powiat tatrzański - URBAN GMINAS";25100;25100;0;
1217011;"Zakopane (1)";25100;25100;0;
1217022;"Biały Dunajec (2)";6828;0;6828;
1217032;"Bukowina Tatrzańska (2)";13568;0;13568;
1217042;"Kościelisko (2)";9095;0;9095;
1217052;"Poronin (2)";11784;0;11784;
1218000;"Powiat wadowicki";157237;39544;117693;
1218000;"Powiat wadowicki - URBAN-RURAL GMINAS";97992;39544;58448;
1218013;"Andrychów (3)";41840;18202;23638;
1218014;"Andrychów - urban area (4)";18202;18202;0;
1218015;"Andrychów - rural area (5)";23638;0;23638;
1218022;"Brzeźnica (2)";10876;0;10876;
1218033;"Kalwaria Zebrzydowska (3)";19825;4288;15537;
1218034;"Kalwaria Zebrzydowska - urban area (4)";4288;4288;0;
1218035;"Kalwaria Zebrzydowska - rural area (5)";15537;0;15537;
1218042;"Lanckorona (2)";6251;0;6251;
1218052;"Mucharz (2)";4175;0;4175;
1218062;"Spytkowice (2)";10067;0;10067;
1218072;"Stryszów (2)";6776;0;6776;
1218082;"Tomice (2)";8303;0;8303;
1218093;"Wadowice (3)";36327;17054;19273;
1218094;"Wadowice - urban area (4)";17054;17054;0;
1218095;"Wadowice - rural area (5)";19273;0;19273;
1218102;"Wieprz (2)";12797;0;12797;
1219000;"Powiat wielicki";144555;45075;99480;
1219000;"Powiat wielicki - URBAN-RURAL GMINAS";102825;45075;57750;
1219012;"Biskupice (2)";11842;0;11842;
1219022;"Gdów (2)";18670;0;18670;
1219032;"Kłaj (2)";11218;0;11218;
1219043;"Niepołomice (3)";33472;17096;16376;
1219044;"Niepołomice - urban area (4)";17096;17096;0;
1219045;"Niepołomice - rural area (5)";16376;0;16376;
1219053;"Wieliczka (3)";69353;27979;41374;
1219054;"Wieliczka - urban area (4)";27979;27979;0;
1219055;"Wieliczka - rural area (5)";41374;0;41374;
1261000;"City with powiat status Kraków";807644;807644;0;
1261000;"City with powiat status Kraków - URBAN GMINAS";807644;807644;0;
1261011;"Kraków (1)";807644;807644;0;
1262000;"City with powiat status Nowy Sącz";79985;79985;0;
1262000;"City with powiat status Nowy Sącz - URBAN GMINAS";79985;79985;0;
1262011;"Nowy Sącz (1)";79985;79985;0;
1263000;"City with powiat status Tarnów";102582;102582;0;
1263000;"City with powiat status Tarnów - URBAN GMINAS";102582;102582;0;
1263011;"Tarnów (1)";102582;102582;0;
1401000;"Powiat białobrzeski";32432;7269;25163;
1401000;"Powiat białobrzeski - URBAN-RURAL GMINAS";12422;7269;5153;
1401013;"Białobrzegi (3)";9756;6398;3358;
1401014;"Białobrzegi - urban area (4)";6398;6398;0;
1401015;"Białobrzegi - rural area (5)";3358;0;3358;
1401022;"Promna (2)";5433;0;5433;
1401032;"Radzanów (2)";3792;0;3792;
1401042;"Stara Błotnica (2)";5423;0;5423;
1401052;"Stromiec (2)";5362;0;5362;
1401063;"Wyśmierzyce (3)";2666;871;1795;
1401064;"Wyśmierzyce - urban area (4)";871;871;0;
1401065;"Wyśmierzyce - rural area (5)";1795;0;1795;
1402000;"Powiat ciechanowski";84917;44397;40520;
1402000;"Powiat ciechanowski - URBAN GMINAS";41634;41634;0;
1402000;"Powiat ciechanowski - URBAN-RURAL GMINAS";7077;2763;4314;
1402011;"Ciechanów (1)";41634;41634;0;
1402022;"Ciechanów (2)";7558;0;7558;
1402033;"Glinojeck (3)";7077;2763;4314;
1402034;"Glinojeck - urban area (4)";2763;2763;0;
1402035;"Glinojeck - rural area (5)";4314;0;4314;
1402042;"Gołymin-Ośrodek (2)";3481;0;3481;
1402052;"Grudusk (2)";3271;0;3271;
1402062;"Ojrzeń (2)";4057;0;4057;
1402072;"Opinogóra Górna (2)";5814;0;5814;
1402082;"Regimin (2)";4688;0;4688;
1402092;"Sońsk (2)";7337;0;7337;
1403000;"Powiat garwoliński";105349;31298;74051;
1403000;"Powiat garwoliński - URBAN GMINAS";21731;21731;0;
1403000;"Powiat garwoliński - URBAN-RURAL GMINAS";24607;9567;15040;
1403011;"Garwolin (1)";17267;17267;0;
1403021;"Łaskarzew (1)";4464;4464;0;
1403032;"Borowie (2)";4895;0;4895;
1403042;"Garwolin (2)";13507;0;13507;
1403052;"Górzno (2)";6715;0;6715;
1403062;"Łaskarzew (2)";5224;0;5224;
1403073;"Maciejowice (3)";6308;1440;4868;
1403074;"Maciejowice - urban area (4)";1440;1440;0;
1403075;"Maciejowice - rural area (5)";4868;0;4868;
1403082;"Miastków Kościelny (2)";4610;0;4610;
1403092;"Parysów (2)";4084;0;4084;
1403103;"Pilawa (3)";10543;4423;6120;
1403104;"Pilawa - urban area (4)";4423;4423;0;
1403105;"Pilawa - rural area (5)";6120;0;6120;
1403112;"Sobolew (2)";7798;0;7798;
1403122;"Trojanów (2)";7092;0;7092;
1403132;"Wilga (2)";5086;0;5086;
1403143;"Żelechów (3)";7756;3704;4052;
1403144;"Żelechów - urban area (4)";3704;3704;0;
1403145;"Żelechów - rural area (5)";4052;0;4052;
1404000;"Powiat gostyniński";41969;18552;23417;
1404000;"Powiat gostyniński - URBAN GMINAS";16839;16839;0;
1404000;"Powiat gostyniński - URBAN-RURAL GMINAS";5564;1713;3851;
1404011;"Gostynin (1)";16839;16839;0;
1404022;"Gostynin (2)";11696;0;11696;
1404032;"Pacyna (2)";3200;0;3200;
1404043;"Sanniki (3)";5564;1713;3851;
1404044;"Sanniki - urban area (4)";1713;1713;0;
1404045;"Sanniki - rural area (5)";3851;0;3851;
1404052;"Szczawin Kościelny (2)";4670;0;4670;
1405000;"Powiat grodziski";106373;55092;51281;
1405000;"Powiat grodziski - URBAN GMINAS";20188;20188;0;
1405000;"Powiat grodziski - URBAN-RURAL GMINAS";55909;34904;21005;
1405011;"Milanówek (1)";16411;16411;0;
1405021;"Podkowa Leśna (1)";3777;3777;0;
1405032;"Baranów (2)";5381;0;5381;
1405043;"Grodzisk Mazowiecki (3)";55909;34904;21005;
1405044;"Grodzisk Mazowiecki - urban area (4)";34904;34904;0;
1405045;"Grodzisk Mazowiecki - rural area (5)";21005;0;21005;
1405052;"Jaktorów (2)";13611;0;13611;
1405062;"Żabia Wola (2)";11284;0;11284;
1406000;"Powiat grójecki";96857;34243;62614;
1406000;"Powiat grójecki - URBAN-RURAL GMINAS";60499;34243;26256;
1406012;"Belsk Duży (2)";6164;0;6164;
1406022;"Błędów (2)";7010;0;7010;
1406032;"Chynów (2)";10163;0;10163;
1406042;"Goszczyn (2)";2840;0;2840;
1406053;"Grójec (3)";26216;16782;9434;
1406054;"Grójec - urban area (4)";16782;16782;0;
1406055;"Grójec - rural area (5)";9434;0;9434;
1406062;"Jasieniec (2)";5339;0;5339;
1406073;"Mogielnica (3)";8128;2119;6009;
1406074;"Mogielnica - urban area (4)";2119;2119;0;
1406075;"Mogielnica - rural area (5)";6009;0;6009;
1406083;"Nowe Miasto nad Pilicą (3)";7100;3475;3625;
1406084;"Nowe Miasto nad Pilicą - urban area (4)";3475;3475;0;
1406085;"Nowe Miasto nad Pilicą - rural area (5)";3625;0;3625;
1406092;"Pniewy (2)";4842;0;4842;
1406113;"Warka (3)";19055;11867;7188;
1406114;"Warka - urban area (4)";11867;11867;0;
1406115;"Warka - rural area (5)";7188;0;7188;
1407000;"Powiat kozienicki";56959;17184;39775;
1407000;"Powiat kozienicki - URBAN-RURAL GMINAS";40661;17184;23477;
1407012;"Garbatka-Letnisko (2)";4726;0;4726;
1407023;"Głowaczów (3)";6670;827;5843;
1407024;"Głowaczów - urban area (4)";827;827;0;
1407025;"Głowaczów - rural area (5)";5843;0;5843;
1407032;"Gniewoszów (2)";3746;0;3746;
1407042;"Grabów nad Pilicą (2)";4097;0;4097;
1407053;"Kozienice (3)";27633;15387;12246;
1407054;"Kozienice - urban area (4)";15387;15387;0;
1407055;"Kozienice - rural area (5)";12246;0;12246;
1407063;"Magnuszew (3)";6358;970;5388;
1407064;"Magnuszew - urban area (4)";970;970;0;
1407065;"Magnuszew - rural area (5)";5388;0;5388;
1407072;"Sieciechów (2)";3729;0;3729;
1408000;"Powiat legionowski";132639;57820;74819;
1408000;"Powiat legionowski - URBAN GMINAS";52494;52494;0;
1408000;"Powiat legionowski - URBAN-RURAL GMINAS";17930;5326;12604;
1408011;"Legionowo (1)";52494;52494;0;
1408022;"Jabłonna (2)";23606;0;23606;
1408032;"Nieporęt (2)";17330;0;17330;
1408043;"Serock (3)";17930;5326;12604;
1408044;"Serock - urban area (4)";5326;5326;0;
1408045;"Serock - rural area (5)";12604;0;12604;
1408052;"Wieliszew (2)";21279;0;21279;
1409000;"Powiat lipski";31399;7499;23900;
1409000;"Powiat lipski - URBAN-RURAL GMINAS";25169;7499;17670;
1409012;"Chotcza (2)";2185;0;2185;
1409023;"Ciepielów (3)";5160;724;4436;
1409024;"Ciepielów - urban area (4)";724;724;0;
1409025;"Ciepielów - rural area (5)";4436;0;4436;
1409033;"Lipsko (3)";9978;4914;5064;
1409034;"Lipsko - urban area (4)";4914;4914;0;
1409035;"Lipsko - rural area (5)";5064;0;5064;
1409042;"Rzeczniów (2)";4045;0;4045;
1409053;"Sienno (3)";5502;936;4566;
1409054;"Sienno - urban area (4)";936;936;0;
1409055;"Sienno - rural area (5)";4566;0;4566;
1409063;"Solec nad Wisłą (3)";4529;925;3604;
1409064;"Solec nad Wisłą - urban area (4)";925;925;0;
1409065;"Solec nad Wisłą - rural area (5)";3604;0;3604;
1410000;"Powiat łosicki";28474;6771;21703;
1410000;"Powiat łosicki - URBAN-RURAL GMINAS";10361;6771;3590;
1410012;"Huszlew (2)";2619;0;2619;
1410023;"Łosice (3)";10361;6771;3590;
1410024;"Łosice - urban area (4)";6771;6771;0;
1410025;"Łosice - rural area (5)";3590;0;3590;
1410032;"Olszanka (2)";2725;0;2725;
1410042;"Platerów (2)";4338;0;4338;
1410052;"Sarnaki (2)";4058;0;4058;
1410062;"Stara Kornica (2)";4373;0;4373;
1411000;"Powiat makowski";41479;11475;30004;
1411000;"Powiat makowski - URBAN GMINAS";8890;8890;0;
1411000;"Powiat makowski - URBAN-RURAL GMINAS";4203;2585;1618;
1411011;"Maków Mazowiecki (1)";8890;8890;0;
1411022;"Czerwonka (2)";2532;0;2532;
1411032;"Karniewo (2)";4806;0;4806;
1411042;"Krasnosielc (2)";5830;0;5830;
1411052;"Młynarze (2)";1609;0;1609;
1411062;"Płoniawy-Bramura (2)";4784;0;4784;
1411073;"Różan (3)";4203;2585;1618;
1411074;"Różan - urban area (4)";2585;2585;0;
1411075;"Różan - rural area (5)";1618;0;1618;
1411082;"Rzewnie (2)";2407;0;2407;
1411092;"Sypniewo (2)";2902;0;2902;
1411102;"Szelków (2)";3516;0;3516;
1412000;"Powiat miński";159589;79192;80397;
1412000;"Powiat miński - URBAN GMINAS";61359;61359;0;
1412000;"Powiat miński - URBAN-RURAL GMINAS";57134;17833;39301;
1412011;"Mińsk Mazowiecki (1)";39823;39823;0;
1412043;"Cegłów (3)";6055;2319;3736;
1412044;"Cegłów - urban area (4)";2319;2319;0;
1412045;"Cegłów - rural area (5)";3736;0;3736;
1412052;"Dębe Wielkie (2)";11916;0;11916;
1412063;"Dobre (3)";5852;1831;4021;
1412064;"Dobre - urban area (4)";1831;1831;0;
1412065;"Dobre - rural area (5)";4021;0;4021;
1412073;"Halinów (3)";18304;3736;14568;
1412074;"Halinów - urban area (4)";3736;3736;0;
1412075;"Halinów - rural area (5)";14568;0;14568;
1412082;"Jakubów (2)";5087;0;5087;
1412093;"Kałuszyn (3)";5505;2680;2825;
1412094;"Kałuszyn - urban area (4)";2680;2680;0;
1412095;"Kałuszyn - rural area (5)";2825;0;2825;
1412103;"Latowicz (3)";5117;1348;3769;
1412104;"Latowicz - urban area (4)";1348;1348;0;
1412105;"Latowicz - rural area (5)";3769;0;3769;
1412112;"Mińsk Mazowiecki (2)";17046;0;17046;
1412123;"Mrozy (3)";8641;3631;5010;
1412124;"Mrozy - urban area (4)";3631;3631;0;
1412125;"Mrozy - rural area (5)";5010;0;5010;
1412133;"Siennica (3)";7660;2288;5372;
1412134;"Siennica - urban area (4)";2288;2288;0;
1412135;"Siennica - rural area (5)";5372;0;5372;
1412142;"Stanisławów (2)";7047;0;7047;
1412151;"Sulejówek (1)";21536;21536;0;
1413000;"Powiat mławski";68872;30735;38137;
1413000;"Powiat mławski - URBAN GMINAS";30735;30735;0;
1413011;"Mława (1)";30735;30735;0;
1413022;"Dzierzgowo (2)";2728;0;2728;
1413032;"Lipowiec Kościelny (2)";4448;0;4448;
1413042;"Radzanów (2)";2903;0;2903;
1413052;"Strzegowo (2)";6981;0;6981;
1413062;"Stupsk (2)";4387;0;4387;
1413072;"Szreńsk (2)";3783;0;3783;
1413082;"Szydłowo (2)";4164;0;4164;
1413092;"Wieczfnia Kościelna (2)";3633;0;3633;
1413102;"Wiśniewo (2)";5110;0;5110;
1414000;"Powiat nowodworski";79484;38955;40529;
1414000;"Powiat nowodworski - URBAN GMINAS";28527;28527;0;
1414000;"Powiat nowodworski - URBAN-RURAL GMINAS";25052;10428;14624;
1414011;"Nowy Dwór Mazowiecki (1)";28527;28527;0;
1414022;"Czosnów (2)";11064;0;11064;
1414032;"Leoncin (2)";5586;0;5586;
1414043;"Nasielsk (3)";19207;7301;11906;
1414044;"Nasielsk - urban area (4)";7301;7301;0;
1414045;"Nasielsk - rural area (5)";11906;0;11906;
1414052;"Pomiechówek (2)";9255;0;9255;
1414063;"Zakroczym (3)";5845;3127;2718;
1414064;"Zakroczym - urban area (4)";3127;3127;0;
1414065;"Zakroczym - rural area (5)";2718;0;2718;
1415000;"Powiat ostrołęcki";87450;3179;84271;
1415000;"Powiat ostrołęcki - URBAN-RURAL GMINAS";9930;3179;6751;
1415012;"Baranowo (2)";5954;0;5954;
1415022;"Czarnia (2)";2203;0;2203;
1415032;"Czerwin (2)";4701;0;4701;
1415042;"Goworowo (2)";7800;0;7800;
1415052;"Kadzidło (2)";11007;0;11007;
1415062;"Lelis (2)";9936;0;9936;
1415072;"Łyse (2)";8175;0;8175;
1415083;"Myszyniec (3)";9930;3179;6751;
1415084;"Myszyniec - urban area (4)";3179;3179;0;
1415085;"Myszyniec - rural area (5)";6751;0;6751;
1415092;"Olszewo-Borki (2)";10998;0;10998;
1415102;"Rzekuń (2)";12258;0;12258;
1415112;"Troszyn (2)";4488;0;4488;
1416000;"Powiat ostrowski";68101;23170;44931;
1416000;"Powiat ostrowski - URBAN GMINAS";21450;21450;0;
1416000;"Powiat ostrowski - URBAN-RURAL GMINAS";2556;1720;836;
1416011;"Ostrów Mazowiecka (1)";21450;21450;0;
1416022;"Andrzejewo (2)";3752;0;3752;
1416032;"Boguty-Pianki (2)";2355;0;2355;
1416043;"Brok (3)";2556;1720;836;
1416044;"Brok - urban area (4)";1720;1720;0;
1416045;"Brok - rural area (5)";836;0;836;
1416052;"Małkinia Górna (2)";10761;0;10761;
1416062;"Nur (2)";2437;0;2437;
1416072;"Ostrów Mazowiecka (2)";12588;0;12588;
1416082;"Stary Lubotyń (2)";3568;0;3568;
1416092;"Szulborze Wielkie (2)";1473;0;1473;
1416102;"Wąsewo (2)";3920;0;3920;
1416112;"Zaręby Kościelne (2)";3241;0;3241;
1417000;"Powiat otwocki";126754;75332;51422;
1417000;"Powiat otwocki - URBAN GMINAS";65004;65004;0;
1417000;"Powiat otwocki - URBAN-RURAL GMINAS";19479;10328;9151;
1417011;"Józefów (1)";21239;21239;0;
1417021;"Otwock (1)";43765;43765;0;
1417032;"Celestynów (2)";11630;0;11630;
1417043;"Karczew (3)";15825;9214;6611;
1417044;"Karczew - urban area (4)";9214;9214;0;
1417045;"Karczew - rural area (5)";6611;0;6611;
1417052;"Kołbiel (2)";8321;0;8321;
1417063;"Osieck (3)";3654;1114;2540;
1417064;"Osieck - urban area (4)";1114;1114;0;
1417065;"Osieck - rural area (5)";2540;0;2540;
1417072;"Sobienie-Jeziory (2)";6196;0;6196;
1417082;"Wiązowna (2)";16124;0;16124;
1418000;"Powiat piaseczyński";216775;85148;131627;
1418000;"Powiat piaseczyński - URBAN-RURAL GMINAS";163831;85148;78683;
1418013;"Góra Kalwaria (3)";28549;12188;16361;
1418014;"Góra Kalwaria - urban area (4)";12188;12188;0;
1418015;"Góra Kalwaria - rural area (5)";16361;0;16361;
1418023;"Konstancin-Jeziorna (3)";25061;16857;8204;
1418024;"Konstancin-Jeziorna - urban area (4)";16857;16857;0;
1418025;"Konstancin-Jeziorna - rural area (5)";8204;0;8204;
1418032;"Lesznowola (2)";39404;0;39404;
1418043;"Piaseczno (3)";97666;51724;45942;
1418044;"Piaseczno - urban area (4)";51724;51724;0;
1418045;"Piaseczno - rural area (5)";45942;0;45942;
1418052;"Prażmów (2)";13540;0;13540;
1418063;"Tarczyn (3)";12555;4379;8176;
1418064;"Tarczyn - urban area (4)";4379;4379;0;
1418065;"Tarczyn - rural area (5)";8176;0;8176;
1419000;"Powiat płocki";109376;10257;99119;
1419000;"Powiat płocki - URBAN-RURAL GMINAS";31276;10257;21019;
1419012;"Bielsk (2)";8854;0;8854;
1419023;"Bodzanów (3)";7739;1136;6603;
1419024;"Bodzanów - urban area (4)";1136;1136;0;
1419025;"Bodzanów - rural area (5)";6603;0;6603;
1419032;"Brudzeń Duży (2)";8214;0;8214;
1419042;"Bulkowo (2)";5174;0;5174;
1419053;"Drobin (3)";7239;2619;4620;
1419054;"Drobin - urban area (4)";2619;2619;0;
1419055;"Drobin - rural area (5)";4620;0;4620;
1419063;"Gąbin (3)";11118;4109;7009;
1419064;"Gąbin - urban area (4)";4109;4109;0;
1419065;"Gąbin - rural area (5)";7009;0;7009;
1419072;"Łąck (2)";5405;0;5405;
1419082;"Mała Wieś (2)";5613;0;5613;
1419092;"Nowy Duninów (2)";3923;0;3923;
1419102;"Radzanowo (2)";8730;0;8730;
1419112;"Słubice (2)";4102;0;4102;
1419122;"Słupno (2)";9111;0;9111;
1419132;"Stara Biała (2)";12261;0;12261;
1419142;"Staroźreby (2)";6713;0;6713;
1419153;"Wyszogród (3)";5180;2393;2787;
1419154;"Wyszogród - urban area (4)";2393;2393;0;
1419155;"Wyszogród - rural area (5)";2787;0;2787;
1420000;"Powiat płoński";83722;29804;53918;
1420000;"Powiat płoński - URBAN GMINAS";25411;25411;0;
1420000;"Powiat płoński - URBAN-RURAL GMINAS";17254;4393;12861;
1420011;"Płońsk (1)";21457;21457;0;
1420021;"Raciąż (1)";3954;3954;0;
1420032;"Baboszewo (2)";7369;0;7369;
1420043;"Czerwińsk nad Wisłą (3)";7117;980;6137;
1420044;"Czerwińsk nad Wisłą - urban area (4)";980;980;0;
1420045;"Czerwińsk nad Wisłą - rural area (5)";6137;0;6137;
1420052;"Dzierzążnia (2)";3349;0;3349;
1420062;"Joniec (2)";2789;0;2789;
1420072;"Naruszewo (2)";5852;0;5852;
1420083;"Nowe Miasto (3)";4561;1513;3048;
1420084;"Nowe Miasto - urban area (4)";1513;1513;0;
1420085;"Nowe Miasto - rural area (5)";3048;0;3048;
1420092;"Płońsk (2)";8466;0;8466;
1420102;"Raciąż (2)";7773;0;7773;
1420113;"Sochocin (3)";5576;1900;3676;
1420114;"Sochocin - urban area (4)";1900;1900;0;
1420115;"Sochocin - rural area (5)";3676;0;3676;
1420122;"Załuski (2)";5459;0;5459;
1421000;"Powiat pruszkowski";180579;103103;77476;
1421000;"Powiat pruszkowski - URBAN GMINAS";88514;88514;0;
1421000;"Powiat pruszkowski - URBAN-RURAL GMINAS";30084;14589;15495;
1421011;"Piastów (1)";22859;22859;0;
1421021;"Pruszków (1)";65655;65655;0;
1421033;"Brwinów (3)";30084;14589;15495;
1421034;"Brwinów - urban area (4)";14589;14589;0;
1421035;"Brwinów - rural area (5)";15495;0;15495;
1421042;"Michałowice (2)";19494;0;19494;
1421052;"Nadarzyn (2)";18554;0;18554;
1421062;"Raszyn (2)";23933;0;23933;
1422000;"Powiat przasnyski";48821;19175;29646;
1422000;"Powiat przasnyski - URBAN GMINAS";16282;16282;0;
1422000;"Powiat przasnyski - URBAN-RURAL GMINAS";9204;2893;6311;
1422011;"Przasnysz (1)";16282;16282;0;
1422023;"Chorzele (3)";9204;2893;6311;
1422024;"Chorzele - urban area (4)";2893;2893;0;
1422025;"Chorzele - rural area (5)";6311;0;6311;
1422032;"Czernice Borowe (2)";3473;0;3473;
1422042;"Jednorożec (2)";6586;0;6586;
1422052;"Krasne (2)";3236;0;3236;
1422062;"Krzynowłoga Mała (2)";3221;0;3221;
1422072;"Przasnysz (2)";6819;0;6819;
1423000;"Powiat przysuski";38450;7015;31435;
1423000;"Powiat przysuski - URBAN-RURAL GMINAS";18442;7015;11427;
1423012;"Borkowice (2)";3948;0;3948;
1423023;"Gielniów (3)";4293;775;3518;
1423024;"Gielniów - urban area (4)";775;775;0;
1423025;"Gielniów - rural area (5)";3518;0;3518;
1423032;"Klwów (2)";3068;0;3068;
1423043;"Odrzywół (3)";3377;995;2382;
1423044;"Odrzywół - urban area (4)";995;995;0;
1423045;"Odrzywół - rural area (5)";2382;0;2382;
1423052;"Potworów (2)";3982;0;3982;
1423063;"Przysucha (3)";10772;5245;5527;
1423064;"Przysucha - urban area (4)";5245;5245;0;
1423065;"Przysucha - rural area (5)";5527;0;5527;
1423072;"Rusinów (2)";3971;0;3971;
1423082;"Wieniawa (2)";5039;0;5039;
1424000;"Powiat pułtuski";50250;19010;31240;
1424000;"Powiat pułtuski - URBAN-RURAL GMINAS";24093;19010;5083;
1424012;"Gzy (2)";3540;0;3540;
1424022;"Obryte (2)";4303;0;4303;
1424032;"Pokrzywnica (2)";5173;0;5173;
1424043;"Pułtusk (3)";24093;19010;5083;
1424044;"Pułtusk - urban area (4)";19010;19010;0;
1424045;"Pułtusk - rural area (5)";5083;0;5083;
1424052;"Świercze (2)";4470;0;4470;
1424062;"Winnica (2)";3981;0;3981;
1424072;"Zatory (2)";4690;0;4690;
1425000;"Powiat radomski";151279;29471;121808;
1425000;"Powiat radomski - URBAN GMINAS";15922;15922;0;
1425000;"Powiat radomski - URBAN-RURAL GMINAS";49687;13549;36138;
1425011;"Pionki (1)";15922;15922;0;
1425022;"Gózd (2)";9544;0;9544;
1425033;"Iłża (3)";13490;4228;9262;
1425034;"Iłża - urban area (4)";4228;4228;0;
1425035;"Iłża - rural area (5)";9262;0;9262;
1425042;"Jastrzębia (2)";7124;0;7124;
1425052;"Jedlińsk (2)";14598;0;14598;
1425063;"Jedlnia-Letnisko (3)";13635;3956;9679;
1425064;"Jedlnia-Letnisko - urban area (4)";3956;3956;0;
1425065;"Jedlnia-Letnisko - rural area (5)";9679;0;9679;
1425072;"Kowala (2)";12497;0;12497;
1425082;"Pionki (2)";9639;0;9639;
1425093;"Przytyk (3)";7036;907;6129;
1425094;"Przytyk - urban area (4)";907;907;0;
1425095;"Przytyk - rural area (5)";6129;0;6129;
1425103;"Skaryszew (3)";15526;4458;11068;
1425104;"Skaryszew - urban area (4)";4458;4458;0;
1425105;"Skaryszew - rural area (5)";11068;0;11068;
1425112;"Wierzbica (2)";9153;0;9153;
1425122;"Wolanów (2)";9023;0;9023;
1425132;"Zakrzew (2)";14092;0;14092;
1426000;"Powiat siedlecki";80461;1592;78869;
1426000;"Powiat siedlecki - URBAN-RURAL GMINAS";5305;1592;3713;
1426012;"Domanice (2)";2483;0;2483;
1426022;"Korczew (2)";2322;0;2322;
1426032;"Kotuń (2)";8127;0;8127;
1426042;"Mokobody (2)";4773;0;4773;
1426053;"Mordy (3)";5305;1592;3713;
1426054;"Mordy - urban area (4)";1592;1592;0;
1426055;"Mordy - rural area (5)";3713;0;3713;
1426062;"Paprotnia (2)";2376;0;2376;
1426072;"Przesmyki (2)";2759;0;2759;
1426082;"Siedlce (2)";19727;0;19727;
1426092;"Skórzec (2)";8243;0;8243;
1426102;"Suchożebry (2)";4737;0;4737;
1426112;"Wiśniew (2)";5728;0;5728;
1426122;"Wodynie (2)";4100;0;4100;
1426132;"Zbuczyn (2)";9781;0;9781;
1427000;"Powiat sierpecki";48035;16827;31208;
1427000;"Powiat sierpecki - URBAN GMINAS";16827;16827;0;
1427011;"Sierpc (1)";16827;16827;0;
1427022;"Gozdowo (2)";5668;0;5668;
1427032;"Mochowo (2)";5520;0;5520;
1427042;"Rościszewo (2)";3717;0;3717;
1427052;"Sierpc (2)";6553;0;6553;
1427062;"Szczutowo (2)";3958;0;3958;
1427072;"Zawidz (2)";5792;0;5792;
1428000;"Powiat sochaczewski";83057;33310;49747;
1428000;"Powiat sochaczewski - URBAN GMINAS";33310;33310;0;
1428011;"Sochaczew (1)";33310;33310;0;
1428022;"Brochów (2)";4413;0;4413;
1428032;"Iłów (2)";5836;0;5836;
1428042;"Młodzieszyn (2)";5638;0;5638;
1428052;"Nowa Sucha (2)";6873;0;6873;
1428062;"Rybno (2)";3425;0;3425;
1428072;"Sochaczew (2)";12009;0;12009;
1428082;"Teresin (2)";11553;0;11553;
1429000;"Powiat sokołowski";49800;20249;29551;
1429000;"Powiat sokołowski - URBAN GMINAS";18295;18295;0;
1429000;"Powiat sokołowski - URBAN-RURAL GMINAS";5286;1954;3332;
1429011;"Sokołów Podlaski (1)";18295;18295;0;
1429022;"Bielany (2)";3467;0;3467;
1429032;"Ceranów (2)";1801;0;1801;
1429042;"Jabłonna Lacka (2)";4042;0;4042;
1429053;"Kosów Lacki (3)";5286;1954;3332;
1429054;"Kosów Lacki - urban area (4)";1954;1954;0;
1429055;"Kosów Lacki - rural area (5)";3332;0;3332;
1429062;"Repki (2)";4570;0;4570;
1429072;"Sabnie (2)";3225;0;3225;
1429082;"Sokołów Podlaski (2)";5758;0;5758;
1429092;"Sterdyń (2)";3356;0;3356;
1430000;"Powiat szydłowiecki";37358;11647;25711;
1430000;"Powiat szydłowiecki - URBAN-RURAL GMINAS";22205;11647;10558;
1430012;"Chlewiska (2)";5476;0;5476;
1430023;"Jastrząb (3)";5111;1186;3925;
1430024;"Jastrząb - urban area (4)";1186;1186;0;
1430025;"Jastrząb - rural area (5)";3925;0;3925;
1430032;"Mirów (2)";3729;0;3729;
1430042;"Orońsko (2)";5948;0;5948;
1430053;"Szydłowiec (3)";17094;10461;6633;
1430054;"Szydłowiec - urban area (4)";10461;10461;0;
1430055;"Szydłowiec - rural area (5)";6633;0;6633;
1432000;"Powiat warszawski zachodni";136132;46281;89851;
1432000;"Powiat warszawski zachodni - URBAN-RURAL GMINAS";86461;46281;40180;
1432013;"Błonie (3)";22511;12215;10296;
1432014;"Błonie - urban area (4)";12215;12215;0;
1432015;"Błonie - rural area (5)";10296;0;10296;
1432022;"Izabelin (2)";10794;0;10794;
1432032;"Kampinos (2)";4502;0;4502;
1432042;"Leszno (2)";11145;0;11145;
1432053;"Łomianki (3)";32101;18258;13843;
1432054;"Łomianki - urban area (4)";18258;18258;0;
1432055;"Łomianki - rural area (5)";13843;0;13843;
1432063;"Ożarów Mazowiecki (3)";31849;15808;16041;
1432064;"Ożarów Mazowiecki - urban area (4)";15808;15808;0;
1432065;"Ożarów Mazowiecki - rural area (5)";16041;0;16041;
1432072;"Stare Babice (2)";23230;0;23230;
1433000;"Powiat węgrowski";61713;18308;43405;
1433000;"Powiat węgrowski - URBAN GMINAS";11791;11791;0;
1433000;"Powiat węgrowski - URBAN-RURAL GMINAS";17235;6517;10718;
1433011;"Węgrów (1)";11791;11791;0;
1433022;"Grębków (2)";4237;0;4237;
1433032;"Korytnica (2)";5500;0;5500;
1433042;"Liw (2)";7022;0;7022;
1433053;"Łochów (3)";17235;6517;10718;
1433054;"Łochów - urban area (4)";6517;6517;0;
1433055;"Łochów - rural area (5)";10718;0;10718;
1433062;"Miedzna (2)";3564;0;3564;
1433072;"Sadowne (2)";5479;0;5479;
1433082;"Stoczek (2)";4463;0;4463;
1433092;"Wierzbno (2)";2422;0;2422;
1434000;"Powiat wołomiński";277102;197592;79510;
1434000;"Powiat wołomiński - URBAN GMINAS";138009;138009;0;
1434000;"Powiat wołomiński - URBAN-RURAL GMINAS";109843;59583;50260;
1434011;"Kobyłka (1)";28512;28512;0;
1434021;"Marki (1)";45877;45877;0;
1434031;"Ząbki (1)";45494;45494;0;
1434041;"Zielonka (1)";18126;18126;0;
1434052;"Dąbrówka (2)";8684;0;8684;
1434063;"Jadów (3)";7004;900;6104;
1434064;"Jadów - urban area (4)";900;900;0;
1434065;"Jadów - rural area (5)";6104;0;6104;
1434072;"Klembów (2)";11464;0;11464;
1434082;"Poświętne (2)";6534;0;6534;
1434093;"Radzymin (3)";31651;15199;16452;
1434094;"Radzymin - urban area (4)";15199;15199;0;
1434095;"Radzymin - rural area (5)";16452;0;16452;
1434102;"Strachówka (2)";2568;0;2568;
1434113;"Tłuszcz (3)";20203;8042;12161;
1434114;"Tłuszcz - urban area (4)";8042;8042;0;
1434115;"Tłuszcz - rural area (5)";12161;0;12161;
1434123;"Wołomin (3)";50985;35442;15543;
1434124;"Wołomin - urban area (4)";35442;35442;0;
1434125;"Wołomin - rural area (5)";15543;0;15543;
1435000;"Powiat wyszkowski";73341;25891;47450;
1435000;"Powiat wyszkowski - URBAN-RURAL GMINAS";39237;25891;13346;
1435012;"Brańszczyk (2)";8044;0;8044;
1435022;"Długosiodło (2)";7413;0;7413;
1435032;"Rząśnik (2)";6812;0;6812;
1435042;"Somianka (2)";5622;0;5622;
1435053;"Wyszków (3)";39237;25891;13346;
1435054;"Wyszków - urban area (4)";25891;25891;0;
1435055;"Wyszków - rural area (5)";13346;0;13346;
1435062;"Zabrodzie (2)";6213;0;6213;
1436000;"Powiat zwoleński";34179;7099;27080;
1436000;"Powiat zwoleński - URBAN-RURAL GMINAS";14308;7099;7209;
1436012;"Kazanów (2)";4224;0;4224;
1436022;"Policzna (2)";5103;0;5103;
1436032;"Przyłęk (2)";5759;0;5759;
1436042;"Tczów (2)";4785;0;4785;
1436053;"Zwoleń (3)";14308;7099;7209;
1436054;"Zwoleń - urban area (4)";7099;7099;0;
1436055;"Zwoleń - rural area (5)";7209;0;7209;
1437000;"Powiat żuromiński";35278;11596;23682;
1437000;"Powiat żuromiński - URBAN-RURAL GMINAS";23969;11596;12373;
1437013;"Bieżuń (3)";4509;1703;2806;
1437014;"Bieżuń - urban area (4)";1703;1703;0;
1437015;"Bieżuń - rural area (5)";2806;0;2806;
1437022;"Kuczbork-Osada (2)";4225;0;4225;
1437033;"Lubowidz (3)";6230;1490;4740;
1437034;"Lubowidz - urban area (4)";1490;1490;0;
1437035;"Lubowidz - rural area (5)";4740;0;4740;
1437042;"Lutocin (2)";3932;0;3932;
1437052;"Siemiątkowo (2)";3152;0;3152;
1437063;"Żuromin (3)";13230;8403;4827;
1437064;"Żuromin - urban area (4)";8403;8403;0;
1437065;"Żuromin - rural area (5)";4827;0;4827;
1438000;"Powiat żyrardowski";75006;45988;29018;
1438000;"Powiat żyrardowski - URBAN GMINAS";38467;38467;0;
1438000;"Powiat żyrardowski - URBAN-RURAL GMINAS";21206;7521;13685;
1438011;"Żyrardów (1)";38467;38467;0;
1438023;"Mszczonów (3)";11277;6065;5212;
1438024;"Mszczonów - urban area (4)";6065;6065;0;
1438025;"Mszczonów - rural area (5)";5212;0;5212;
1438032;"Puszcza Mariańska (2)";8811;0;8811;
1438042;"Radziejowice (2)";6522;0;6522;
1438053;"Wiskitki (3)";9929;1456;8473;
1438054;"Wiskitki - urban area (4)";1456;1456;0;
1438055;"Wiskitki - rural area (5)";8473;0;8473;
1461000;"City with powiat status Ostrołęka";47922;47922;0;
1461000;"City with powiat status Ostrołęka - URBAN GMINAS";47922;47922;0;
1461011;"Ostrołęka (1)";47922;47922;0;
1462000;"City with powiat status Płock";110495;110495;0;
1462000;"City with powiat status Płock - URBAN GMINAS";110495;110495;0;
1462011;"Płock (1)";110495;110495;0;
1463000;"City with powiat status Radom";194916;194916;0;
1463000;"City with powiat status Radom - URBAN GMINAS";194916;194916;0;
1463011;"Radom (1)";194916;194916;0;
1464000;"City with powiat status Siedlce";75072;75072;0;
1464000;"City with powiat status Siedlce - URBAN GMINAS";75072;75072;0;
1464011;"Siedlce (1)";75072;75072;0;
1465000;"City with powiat status Capital City Warszawa";1862402;1862402;0;
1465000;"City with powiat status Capital City Warszawa - URBAN GMINAS";1862402;1862402;0;
1465011;"Capital city Warszawa since 2002 (1)";1862402;1862402;0;
1465028;"Bemowo - district (8)";129146;129146;0;
1465038;"Białołęka - district (8)";160386;160386;0;
1465048;"Bielany - district (8)";130910;130910;0;
1465058;"Mokotów - district (8)";225149;225149;0;
1465068;"Ochota - district (8)";79115;79115;0;
1465078;"Praga-Południe - district (8)";185633;185633;0;
1465088;"Praga-Północ - district (8)";59263;59263;0;
1465098;"Rembertów - district (8)";24888;24888;0;
1465108;"Śródmieście - district (8)";97073;97073;0;
1465118;"Targówek - district (8)";122758;122758;0;
1465128;"Ursus - district (8)";70248;70248;0;
1465138;"Ursynów - district (8)";149326;149326;0;
1465148;"Wawer - district (8)";89166;89166;0;
1465158;"Wesoła - district (8)";26659;26659;0;
1465168;"Wilanów - district (8)";52855;52855;0;
1465178;"Włochy - district (8)";50554;50554;0;
1465188;"Wola - district (8)";150588;150588;0;
1465198;"Żoliborz - district (8)";58685;58685;0;
1601000;"Powiat brzeski";85876;46646;39230;
1601000;"Powiat brzeski - URBAN GMINAS";33230;33230;0;
1601000;"Powiat brzeski - URBAN-RURAL GMINAS";30225;13416;16809;
1601011;"Brzeg (1)";33230;33230;0;
1601022;"Skarbimierz (2)";8776;0;8776;
1601033;"Grodków (3)";17839;7856;9983;
1601034;"Grodków - urban area (4)";7856;7856;0;
1601035;"Grodków - rural area (5)";9983;0;9983;
1601043;"Lewin Brzeski (3)";12386;5560;6826;
1601044;"Lewin Brzeski - urban area (4)";5560;5560;0;
1601045;"Lewin Brzeski - rural area (5)";6826;0;6826;
1601052;"Lubsza (2)";8942;0;8942;
1601062;"Olszanka (2)";4703;0;4703;
1602000;"Powiat głubczycki";42392;19727;22665;
1602000;"Powiat głubczycki - URBAN-RURAL GMINAS";36178;19727;16451;
1602013;"Baborów (3)";5633;2793;2840;
1602014;"Baborów - urban area (4)";2793;2793;0;
1602015;"Baborów - rural area (5)";2840;0;2840;
1602022;"Branice (2)";6214;0;6214;
1602033;"Głubczyce (3)";20705;11534;9171;
1602034;"Głubczyce - urban area (4)";11534;11534;0;
1602035;"Głubczyce - rural area (5)";9171;0;9171;
1602043;"Kietrz (3)";9840;5400;4440;
1602044;"Kietrz - urban area (4)";5400;5400;0;
1602045;"Kietrz - rural area (5)";4440;0;4440;
1603000;"Powiat kędzierzyńsko-kozielski";85725;54029;31696;
1603000;"Powiat kędzierzyńsko-kozielski - URBAN GMINAS";54029;54029;0;
1603011;"Kędzierzyn-Koźle (1)";54029;54029;0;
1603022;"Bierawa (2)";7540;0;7540;
1603032;"Cisek (2)";5306;0;5306;
1603042;"Pawłowiczki (2)";6980;0;6980;
1603052;"Polska Cerekiew (2)";3729;0;3729;
1603062;"Reńska Wieś (2)";8141;0;8141;
1604000;"Powiat kluczborski";60911;30528;30383;
1604000;"Powiat kluczborski - URBAN-RURAL GMINAS";54587;30528;24059;
1604013;"Byczyna (3)";8526;3340;5186;
1604014;"Byczyna - urban area (4)";3340;3340;0;
1604015;"Byczyna - rural area (5)";5186;0;5186;
1604023;"Kluczbork (3)";33949;21888;12061;
1604024;"Kluczbork - urban area (4)";21888;21888;0;
1604025;"Kluczbork - rural area (5)";12061;0;12061;
1604032;"Lasowice Wielkie (2)";6324;0;6324;
1604043;"Wołczyn (3)";12112;5300;6812;
1604044;"Wołczyn - urban area (4)";5300;5300;0;
1604045;"Wołczyn - rural area (5)";6812;0;6812;
1605000;"Powiat krapkowicki";59414;33200;26214;
1605000;"Powiat krapkowicki - URBAN-RURAL GMINAS";54273;33200;21073;
1605013;"Gogolin (3)";11631;6412;5219;
1605014;"Gogolin - urban area (4)";6412;6412;0;
1605015;"Gogolin - rural area (5)";5219;0;5219;
1605023;"Krapkowice (3)";21433;15199;6234;
1605024;"Krapkowice - urban area (4)";15199;15199;0;
1605025;"Krapkowice - rural area (5)";6234;0;6234;
1605033;"Strzeleczki (3)";7200;1507;5693;
1605034;"Strzeleczki - urban area (4)";1507;1507;0;
1605035;"Strzeleczki - rural area (5)";5693;0;5693;
1605042;"Walce (2)";5141;0;5141;
1605053;"Zdzieszowice (3)";14009;10082;3927;
1605054;"Zdzieszowice - urban area (4)";10082;10082;0;
1605055;"Zdzieszowice - rural area (5)";3927;0;3927;
1606000;"Powiat namysłowski";41931;16776;25155;
1606000;"Powiat namysłowski - URBAN-RURAL GMINAS";26286;16776;9510;
1606012;"Domaszowice (2)";3462;0;3462;
1606023;"Namysłów (3)";26286;16776;9510;
1606024;"Namysłów - urban area (4)";16776;16776;0;
1606025;"Namysłów - rural area (5)";9510;0;9510;
1606032;"Pokój (2)";4988;0;4988;
1606042;"Świerczów (2)";3027;0;3027;
1606052;"Wilków (2)";4168;0;4168;
1607000;"Powiat nyski";127390;67350;60040;
1607000;"Powiat nyski - URBAN-RURAL GMINAS";108004;67350;40654;
1607013;"Głuchołazy (3)";22183;12545;9638;
1607014;"Głuchołazy - urban area (4)";12545;12545;0;
1607015;"Głuchołazy - rural area (5)";9638;0;9638;
1607022;"Kamiennik (2)";3134;0;3134;
1607033;"Korfantów (3)";8348;1688;6660;
1607034;"Korfantów - urban area (4)";1688;1688;0;
1607035;"Korfantów - rural area (5)";6660;0;6660;
1607042;"Łambinowice (2)";7117;0;7117;
1607053;"Nysa (3)";53473;40417;13056;
1607054;"Nysa - urban area (4)";40417;40417;0;
1607055;"Nysa - rural area (5)";13056;0;13056;
1607063;"Otmuchów (3)";12650;6108;6542;
1607064;"Otmuchów - urban area (4)";6108;6108;0;
1607065;"Otmuchów - rural area (5)";6542;0;6542;
1607073;"Paczków (3)";11350;6592;4758;
1607074;"Paczków - urban area (4)";6592;6592;0;
1607075;"Paczków - rural area (5)";4758;0;4758;
1607082;"Pakosławice (2)";3275;0;3275;
1607092;"Skoroszyce (2)";5860;0;5860;
1608000;"Powiat oleski";61023;21877;39146;
1608000;"Powiat oleski - URBAN-RURAL GMINAS";45947;21877;24070;
1608013;"Dobrodzień (3)";9099;3415;5684;
1608014;"Dobrodzień - urban area (4)";3415;3415;0;
1608015;"Dobrodzień - rural area (5)";5684;0;5684;
1608023;"Gorzów Śląski (3)";6886;2413;4473;
1608024;"Gorzów Śląski - urban area (4)";2413;2413;0;
1608025;"Gorzów Śląski - rural area (5)";4473;0;4473;
1608033;"Olesno (3)";17169;9016;8153;
1608034;"Olesno - urban area (4)";9016;9016;0;
1608035;"Olesno - rural area (5)";8153;0;8153;
1608043;"Praszka (3)";12793;7033;5760;
1608044;"Praszka - urban area (4)";7033;7033;0;
1608045;"Praszka - rural area (5)";5760;0;5760;
1608052;"Radłów (2)";4032;0;4032;
1608062;"Rudniki (2)";7622;0;7622;
1608072;"Zębowice (2)";3422;0;3422;
1609000;"Powiat opolski";120788;19869;100919;
1609000;"Powiat opolski - URBAN-RURAL GMINAS";44795;19869;24926;
1609012;"Chrząstowice (2)";7183;0;7183;
1609022;"Dąbrowa (2)";8221;0;8221;
1609032;"Dobrzeń Wielki (2)";9140;0;9140;
1609042;"Komprachcice (2)";9341;0;9341;
1609052;"Łubniany (2)";10135;0;10135;
1609062;"Murów (2)";5023;0;5023;
1609073;"Niemodlin (3)";12476;5809;6667;
1609074;"Niemodlin - urban area (4)";5809;5809;0;
1609075;"Niemodlin - rural area (5)";6667;0;6667;
1609083;"Ozimek (3)";18403;7877;10526;
1609084;"Ozimek - urban area (4)";7877;7877;0;
1609085;"Ozimek - rural area (5)";10526;0;10526;
1609092;"Popielów (2)";7595;0;7595;
1609103;"Prószków (3)";8995;2553;6442;
1609104;"Prószków - urban area (4)";2553;2553;0;
1609105;"Prószków - rural area (5)";6442;0;6442;
1609112;"Tarnów Opolski (2)";9365;0;9365;
1609123;"Tułowice (3)";4921;3630;1291;
1609124;"Tułowice - urban area (4)";3630;3630;0;
1609125;"Tułowice - rural area (5)";1291;0;1291;
1609132;"Turawa (2)";9990;0;9990;
1610000;"Powiat prudnicki";51171;26475;24696;
1610000;"Powiat prudnicki - URBAN-RURAL GMINAS";47025;26475;20550;
1610013;"Biała (3)";9808;2232;7576;
1610014;"Biała - urban area (4)";2232;2232;0;
1610015;"Biała - rural area (5)";7576;0;7576;
1610023;"Głogówek (3)";12498;5426;7072;
1610024;"Głogówek - urban area (4)";5426;5426;0;
1610025;"Głogówek - rural area (5)";7072;0;7072;
1610032;"Lubrza (2)";4146;0;4146;
1610043;"Prudnik (3)";24719;18817;5902;
1610044;"Prudnik - urban area (4)";18817;18817;0;
1610045;"Prudnik - rural area (5)";5902;0;5902;
1611000;"Powiat strzelecki";70916;30698;40218;
1611000;"Powiat strzelecki - URBAN-RURAL GMINAS";58569;30698;27871;
1611012;"Izbicko (2)";5310;0;5310;
1611022;"Jemielnica (2)";7037;0;7037;
1611033;"Kolonowskie (3)";5657;3187;2470;
1611034;"Kolonowskie - urban area (4)";3187;3187;0;
1611035;"Kolonowskie - rural area (5)";2470;0;2470;
1611043;"Leśnica (3)";7351;2517;4834;
1611044;"Leśnica - urban area (4)";2517;2517;0;
1611045;"Leśnica - rural area (5)";4834;0;4834;
1611053;"Strzelce Opolskie (3)";28833;16857;11976;
1611054;"Strzelce Opolskie - urban area (4)";16857;16857;0;
1611055;"Strzelce Opolskie - rural area (5)";11976;0;11976;
1611063;"Ujazd (3)";6359;1829;4530;
1611064;"Ujazd - urban area (4)";1829;1829;0;
1611065;"Ujazd - rural area (5)";4530;0;4530;
1611073;"Zawadzkie (3)";10369;6308;4061;
1611074;"Zawadzkie - urban area (4)";6308;6308;0;
1611075;"Zawadzkie - rural area (5)";4061;0;4061;
1661000;"City with powiat status Opole";125812;125812;0;
1661000;"City with powiat status Opole - URBAN GMINAS";125812;125812;0;
1661011;"Opole (1)";125812;125812;0;
1801000;"Powiat bieszczadzki";20513;8313;12200;
1801000;"Powiat bieszczadzki - URBAN-RURAL GMINAS";16197;8313;7884;
1801032;"Czarna (2)";2353;0;2353;
1801052;"Lutowiska (2)";1963;0;1963;
1801083;"Ustrzyki Dolne (3)";16197;8313;7884;
1801084;"Ustrzyki Dolne - urban area (4)";8313;8313;0;
1801085;"Ustrzyki Dolne - rural area (5)";7884;0;7884;
1802000;"Powiat brzozowski";62971;7138;55833;
1802000;"Powiat brzozowski - URBAN-RURAL GMINAS";25790;7138;18652;
1802013;"Brzozów (3)";25790;7138;18652;
1802014;"Brzozów - urban area (4)";7138;7138;0;
1802015;"Brzozów - rural area (5)";18652;0;18652;
1802022;"Domaradz (2)";5789;0;5789;
1802032;"Dydnia (2)";7506;0;7506;
1802042;"Haczów (2)";8927;0;8927;
1802052;"Jasienica Rosielna (2)";7525;0;7525;
1802062;"Nozdrzec (2)";7434;0;7434;
1803000;"Powiat dębicki";132320;50416;81904;
1803000;"Powiat dębicki - URBAN GMINAS";42743;42743;0;
1803000;"Powiat dębicki - URBAN-RURAL GMINAS";30900;7673;23227;
1803011;"Dębica (1)";42743;42743;0;
1803023;"Brzostek (3)";12628;2676;9952;
1803024;"Brzostek - urban area (4)";2676;2676;0;
1803025;"Brzostek - rural area (5)";9952;0;9952;
1803032;"Czarna (2)";13337;0;13337;
1803042;"Dębica (2)";25661;0;25661;
1803052;"Jodłowa (2)";5210;0;5210;
1803063;"Pilzno (3)";18272;4997;13275;
1803064;"Pilzno - urban area (4)";4997;4997;0;
1803065;"Pilzno - rural area (5)";13275;0;13275;
1803072;"Żyraków (2)";14469;0;14469;
1804000;"Powiat jarosławski";115480;43698;71782;
1804000;"Powiat jarosławski - URBAN GMINAS";40077;40077;0;
1804000;"Powiat jarosławski - URBAN-RURAL GMINAS";9252;3621;5631;
1804011;"Jarosław (1)";35166;35166;0;
1804021;"Radymno (1)";4911;4911;0;
1804032;"Chłopice (2)";5240;0;5240;
1804042;"Jarosław (2)";13090;0;13090;
1804052;"Laszki (2)";6524;0;6524;
1804062;"Pawłosiów (2)";8373;0;8373;
1804073;"Pruchnik (3)";9252;3621;5631;
1804074;"Pruchnik - urban area (4)";3621;3621;0;
1804075;"Pruchnik - rural area (5)";5631;0;5631;
1804082;"Radymno (2)";10868;0;10868;
1804092;"Rokietnica (2)";4115;0;4115;
1804102;"Roźwienica (2)";6129;0;6129;
1804112;"Wiązownica (2)";11812;0;11812;
1805000;"Powiat jasielski";108407;33920;74487;
1805000;"Powiat jasielski - URBAN GMINAS";32566;32566;0;
1805000;"Powiat jasielski - URBAN-RURAL GMINAS";8565;1354;7211;
1805011;"Jasło (1)";32566;32566;0;
1805022;"Brzyska (2)";6315;0;6315;
1805032;"Dębowiec (2)";8773;0;8773;
1805042;"Jasło (2)";15897;0;15897;
1805053;"Kołaczyce (3)";8565;1354;7211;
1805054;"Kołaczyce - urban area (4)";1354;1354;0;
1805055;"Kołaczyce - rural area (5)";7211;0;7211;
1805062;"Krempna (2)";1680;0;1680;
1805072;"Nowy Żmigród (2)";8557;0;8557;
1805082;"Osiek Jasielski (2)";5150;0;5150;
1805092;"Skołyszyn (2)";11934;0;11934;
1805112;"Tarnowiec (2)";8970;0;8970;
1806000;"Powiat kolbuszowski";61049;8451;52598;
1806000;"Powiat kolbuszowski - URBAN-RURAL GMINAS";24173;8451;15722;
1806012;"Cmolas (2)";7978;0;7978;
1806023;"Kolbuszowa (3)";24173;8451;15722;
1806024;"Kolbuszowa - urban area (4)";8451;8451;0;
1806025;"Kolbuszowa - rural area (5)";15722;0;15722;
1806032;"Majdan Królewski (2)";9542;0;9542;
1806042;"Niwiska (2)";6208;0;6208;
1806052;"Raniżów (2)";6900;0;6900;
1806062;"Dzikowiec (2)";6248;0;6248;
1807000;"Powiat krośnieński";108439;12520;95919;
1807000;"Powiat krośnieński - URBAN-RURAL GMINAS";54049;12520;41529;
1807012;"Chorkówka (2)";13468;0;13468;
1807023;"Dukla (3)";13814;1952;11862;
1807024;"Dukla - urban area (4)";1952;1952;0;
1807025;"Dukla - rural area (5)";11862;0;11862;
1807033;"Iwonicz-Zdrój (3)";10206;1533;8673;
1807034;"Iwonicz-Zdrój - urban area (4)";1533;1533;0;
1807035;"Iwonicz-Zdrój - rural area (5)";8673;0;8673;
1807043;"Jedlicze (3)";14889;5501;9388;
1807044;"Jedlicze - urban area (4)";5501;5501;0;
1807045;"Jedlicze - rural area (5)";9388;0;9388;
1807052;"Korczyna (2)";11057;0;11057;
1807062;"Krościenko Wyżne (2)";5320;0;5320;
1807072;"Miejsce Piastowe (2)";13297;0;13297;
1807083;"Rymanów (3)";15140;3534;11606;
1807084;"Rymanów - urban area (4)";3534;3534;0;
1807085;"Rymanów - rural area (5)";11606;0;11606;
1807092;"Wojaszówka (2)";9192;0;9192;
1807102;"Jaśliska (2)";2056;0;2056;
1808000;"Powiat leżajski";66445;17913;48532;
1808000;"Powiat leżajski - URBAN GMINAS";12625;12625;0;
1808000;"Powiat leżajski - URBAN-RURAL GMINAS";20827;5288;15539;
1808011;"Leżajsk (1)";12625;12625;0;
1808022;"Grodzisko Dolne (2)";7707;0;7707;
1808032;"Kuryłówka (2)";5491;0;5491;
1808042;"Leżajsk (2)";19795;0;19795;
1808053;"Nowa Sarzyna (3)";20827;5288;15539;
1808054;"Nowa Sarzyna - urban area (4)";5288;5288;0;
1808055;"Nowa Sarzyna - rural area (5)";15539;0;15539;
1809000;"Powiat lubaczowski";52240;17848;34392;
1809000;"Powiat lubaczowski - URBAN GMINAS";11285;11285;0;
1809000;"Powiat lubaczowski - URBAN-RURAL GMINAS";20210;6563;13647;
1809011;"Lubaczów (1)";11285;11285;0;
1809023;"Cieszanów (3)";6681;1803;4878;
1809024;"Cieszanów - urban area (4)";1803;1803;0;
1809025;"Cieszanów - rural area (5)";4878;0;4878;
1809032;"Horyniec-Zdrój (2)";4257;0;4257;
1809042;"Lubaczów (2)";8912;0;8912;
1809053;"Narol (3)";7470;1957;5513;
1809054;"Narol - urban area (4)";1957;1957;0;
1809055;"Narol - rural area (5)";5513;0;5513;
1809063;"Oleszyce (3)";6059;2803;3256;
1809064;"Oleszyce - urban area (4)";2803;2803;0;
1809065;"Oleszyce - rural area (5)";3256;0;3256;
1809072;"Stary Dzików (2)";3940;0;3940;
1809082;"Wielkie Oczy (2)";3636;0;3636;
1810000;"Powiat łańcucki";80757;17763;62994;
1810000;"Powiat łańcucki - URBAN GMINAS";17763;17763;0;
1810011;"Łańcut (1)";17763;17763;0;
1810022;"Białobrzegi (2)";8696;0;8696;
1810032;"Czarna (2)";12091;0;12091;
1810042;"Łańcut (2)";21745;0;21745;
1810052;"Markowa (2)";6319;0;6319;
1810062;"Rakszawa (2)";7216;0;7216;
1810072;"Żołynia (2)";6927;0;6927;
1811000;"Powiat mielecki";132723;61971;70752;
1811000;"Powiat mielecki - URBAN GMINAS";56719;56719;0;
1811000;"Powiat mielecki - URBAN-RURAL GMINAS";26238;5252;20986;
1811011;"Mielec (1)";56719;56719;0;
1811022;"Borowa (2)";5223;0;5223;
1811032;"Czermin (2)";7061;0;7061;
1811042;"Gawłuszowice (2)";2749;0;2749;
1811052;"Mielec (2)";13702;0;13702;
1811062;"Padew Narodowa (2)";5104;0;5104;
1811073;"Przecław (3)";12012;1828;10184;
1811074;"Przecław - urban area (4)";1828;1828;0;
1811075;"Przecław - rural area (5)";10184;0;10184;
1811083;"Radomyśl Wielki (3)";14226;3424;10802;
1811084;"Radomyśl Wielki - urban area (4)";3424;3424;0;
1811085;"Radomyśl Wielki - rural area (5)";10802;0;10802;
1811092;"Tuszów Narodowy (2)";8289;0;8289;
1811102;"Wadowice Górne (2)";7638;0;7638;
1812000;"Powiat niżański";63406;22043;41363;
1812000;"Powiat niżański - URBAN-RURAL GMINAS";38740;22043;16697;
1812012;"Harasiuki (2)";5677;0;5677;
1812022;"Jarocin (2)";5030;0;5030;
1812032;"Jeżowe (2)";9871;0;9871;
1812042;"Krzeszów (2)";4088;0;4088;
1812053;"Nisko (3)";21129;14353;6776;
1812054;"Nisko - urban area (4)";14353;14353;0;
1812055;"Nisko - rural area (5)";6776;0;6776;
1812063;"Rudnik nad Sanem (3)";9776;6326;3450;
1812064;"Rudnik nad Sanem - urban area (4)";6326;6326;0;
1812065;"Rudnik nad Sanem - rural area (5)";3450;0;3450;
1812073;"Ulanów (3)";7835;1364;6471;
1812074;"Ulanów - urban area (4)";1364;1364;0;
1812075;"Ulanów - rural area (5)";6471;0;6471;
1813000;"Powiat przemyski";70933;1780;69153;
1813000;"Powiat przemyski - URBAN-RURAL GMINAS";14589;1780;12809;
1813013;"Bircza (3)";5870;988;4882;
1813014;"Bircza - urban area (4)";988;988;0;
1813015;"Bircza - rural area (5)";4882;0;4882;
1813023;"Dubiecko (3)";8719;792;7927;
1813024;"Dubiecko - urban area (4)";792;792;0;
1813025;"Dubiecko - rural area (5)";7927;0;7927;
1813032;"Fredropol (2)";5161;0;5161;
1813042;"Krasiczyn (2)";5096;0;5096;
1813052;"Krzywcza (2)";4469;0;4469;
1813062;"Medyka (2)";6263;0;6263;
1813072;"Orły (2)";8510;0;8510;
1813082;"Przemyśl (2)";10672;0;10672;
1813092;"Stubno (2)";3655;0;3655;
1813102;"Żurawica (2)";12518;0;12518;
1814000;"Powiat przeworski";75586;20512;55074;
1814000;"Powiat przeworski - URBAN GMINAS";14477;14477;0;
1814000;"Powiat przeworski - URBAN-RURAL GMINAS";22593;6035;16558;
1814011;"Przeworsk (1)";14477;14477;0;
1814022;"Adamówka (2)";3989;0;3989;
1814032;"Gać (2)";4516;0;4516;
1814043;"Jawornik Polski (3)";4211;1161;3050;
1814044;"Jawornik Polski - urban area (4)";1161;1161;0;
1814045;"Jawornik Polski - rural area (5)";3050;0;3050;
1814053;"Kańczuga (3)";11632;2881;8751;
1814054;"Kańczuga - urban area (4)";2881;2881;0;
1814055;"Kańczuga - rural area (5)";8751;0;8751;
1814062;"Przeworsk (2)";14573;0;14573;
1814073;"Sieniawa (3)";6750;1993;4757;
1814074;"Sieniawa - urban area (4)";1993;1993;0;
1814075;"Sieniawa - rural area (5)";4757;0;4757;
1814082;"Tryńcza (2)";8522;0;8522;
1814092;"Zarzecze (2)";6916;0;6916;
1815000;"Powiat ropczycko-sędziszowski";74013;28217;45796;
1815000;"Powiat ropczycko-sędziszowski - URBAN-RURAL GMINAS";50989;28217;22772;
1815012;"Iwierzyce (2)";7783;0;7783;
1815022;"Ostrów (2)";7504;0;7504;
1815033;"Ropczyce (3)";27204;15812;11392;
1815034;"Ropczyce - urban area (4)";15812;15812;0;
1815035;"Ropczyce - rural area (5)";11392;0;11392;
1815043;"Sędziszów Małopolski (3)";23785;12405;11380;
1815044;"Sędziszów Małopolski - urban area (4)";12405;12405;0;
1815045;"Sędziszów Małopolski - rural area (5)";11380;0;11380;
1815052;"Wielopole Skrzyńskie (2)";7737;0;7737;
1816000;"Powiat rzeszowski";176357;34042;142315;
1816000;"Powiat rzeszowski - URBAN GMINAS";5995;5995;0;
1816000;"Powiat rzeszowski - URBAN-RURAL GMINAS";81724;28047;53677;
1816011;"Dynów (1)";5995;5995;0;
1816023;"Błażowa (3)";10792;2083;8709;
1816024;"Błażowa - urban area (4)";2083;2083;0;
1816025;"Błażowa - rural area (5)";8709;0;8709;
1816033;"Boguchwała (3)";22150;6338;15812;
1816034;"Boguchwała - urban area (4)";6338;6338;0;
1816035;"Boguchwała - rural area (5)";15812;0;15812;
1816042;"Chmielnik (2)";7386;0;7386;
1816052;"Dynów (2)";6574;0;6574;
1816063;"Głogów Małopolski (3)";19860;10676;9184;
1816064;"Głogów Małopolski - urban area (4)";10676;10676;0;
1816065;"Głogów Małopolski - rural area (5)";9184;0;9184;
1816072;"Hyżne (2)";6989;0;6989;
1816082;"Kamień (2)";6826;0;6826;
1816092;"Krasne (2)";13100;0;13100;
1816102;"Lubenia (2)";6566;0;6566;
1816113;"Sokołów Małopolski (3)";17355;4363;12992;
1816114;"Sokołów Małopolski - urban area (4)";4363;4363;0;
1816115;"Sokołów Małopolski - rural area (5)";12992;0;12992;
1816122;"Świlcza (2)";16787;0;16787;
1816132;"Trzebownisko (2)";24410;0;24410;
1816143;"Tyczyn (3)";11567;4587;6980;
1816144;"Tyczyn - urban area (4)";4587;4587;0;
1816145;"Tyczyn - rural area (5)";6980;0;6980;
1817000;"Powiat sanocki";89356;38995;50361;
1817000;"Powiat sanocki - URBAN GMINAS";34115;34115;0;
1817000;"Powiat sanocki - URBAN-RURAL GMINAS";12599;4880;7719;
1817011;"Sanok (1)";34115;34115;0;
1817022;"Besko (2)";4354;0;4354;
1817032;"Bukowsko (2)";5279;0;5279;
1817042;"Komańcza (2)";4083;0;4083;
1817052;"Sanok (2)";18090;0;18090;
1817062;"Tyrawa Wołoska (2)";1913;0;1913;
1817073;"Zagórz (3)";12599;4880;7719;
1817074;"Zagórz - urban area (4)";4880;4880;0;
1817075;"Zagórz - rural area (5)";7719;0;7719;
1817082;"Zarszyn (2)";8923;0;8923;
1818000;"Powiat stalowowolski";100446;57392;43054;
1818000;"Powiat stalowowolski - URBAN GMINAS";54631;54631;0;
1818000;"Powiat stalowowolski - URBAN-RURAL GMINAS";7988;2761;5227;
1818011;"Stalowa Wola (1)";54631;54631;0;
1818022;"Bojanów (2)";7631;0;7631;
1818032;"Pysznica (2)";11981;0;11981;
1818042;"Radomyśl nad Sanem (2)";7220;0;7220;
1818053;"Zaklików (3)";7988;2761;5227;
1818054;"Zaklików - urban area (4)";2761;2761;0;
1818055;"Zaklików - rural area (5)";5227;0;5227;
1818062;"Zaleszany (2)";10995;0;10995;
1819000;"Powiat strzyżowski";59025;8386;50639;
1819000;"Powiat strzyżowski - URBAN-RURAL GMINAS";19683;8386;11297;
1819012;"Czudec (2)";11526;0;11526;
1819022;"Frysztak (2)";10038;0;10038;
1819032;"Niebylec (2)";10223;0;10223;
1819043;"Strzyżów (3)";19683;8386;11297;
1819044;"Strzyżów - urban area (4)";8386;8386;0;
1819045;"Strzyżów - rural area (5)";11297;0;11297;
1819052;"Wiśniowa (2)";7555;0;7555;
1820000;"Powiat tarnobrzeski";50729;11701;39028;
1820000;"Powiat tarnobrzeski - URBAN-RURAL GMINAS";28221;11701;16520;
1820013;"Baranów Sandomierski (3)";11275;1390;9885;
1820014;"Baranów Sandomierski - urban area (4)";1390;1390;0;
1820015;"Baranów Sandomierski - rural area (5)";9885;0;9885;
1820022;"Gorzyce (2)";12561;0;12561;
1820032;"Grębów (2)";9947;0;9947;
1820043;"Nowa Dęba (3)";16946;10311;6635;
1820044;"Nowa Dęba - urban area (4)";10311;10311;0;
1820045;"Nowa Dęba - rural area (5)";6635;0;6635;
1821000;"Powiat leski";25315;5079;20236;
1821000;"Powiat leski - URBAN-RURAL GMINAS";10765;5079;5686;
1821012;"Baligród (2)";3038;0;3038;
1821022;"Cisna (2)";1697;0;1697;
1821033;"Lesko (3)";10765;5079;5686;
1821034;"Lesko - urban area (4)";5079;5079;0;
1821035;"Lesko - rural area (5)";5686;0;5686;
1821042;"Olszanica (2)";4628;0;4628;
1821052;"Solina (2)";5187;0;5187;
1861000;"City with powiat status Krosno";43809;43809;0;
1861000;"City with powiat status Krosno - URBAN GMINAS";43809;43809;0;
1861011;"Krosno (1)";43809;43809;0;
1862000;"City with powiat status Przemyśl";55642;55642;0;
1862000;"City with powiat status Przemyśl - URBAN GMINAS";55642;55642;0;
1862011;"Przemyśl (1)";55642;55642;0;
1863000;"City with powiat status Rzeszów";197706;197706;0;
1863000;"City with powiat status Rzeszów - URBAN GMINAS";197706;197706;0;
1863011;"Rzeszów (1)";197706;197706;0;
1864000;"City with powiat status Tarnobrzeg";43472;43472;0;
1864000;"City with powiat status Tarnobrzeg - URBAN GMINAS";43472;43472;0;
1864011;"Tarnobrzeg (1)";43472;43472;0;
2001000;"Powiat augustowski";54245;30965;23280;
2001000;"Powiat augustowski - URBAN GMINAS";28917;28917;0;
2001000;"Powiat augustowski - URBAN-RURAL GMINAS";4332;2048;2284;
2001011;"Augustów (1)";28917;28917;0;
2001022;"Augustów (2)";6394;0;6394;
2001032;"Bargłów Kościelny (2)";4972;0;4972;
2001043;"Lipsk (3)";4332;2048;2284;
2001044;"Lipsk - urban area (4)";2048;2048;0;
2001045;"Lipsk - rural area (5)";2284;0;2284;
2001052;"Nowinka (2)";2882;0;2882;
2001062;"Płaska (2)";2281;0;2281;
2001072;"Sztabin (2)";4467;0;4467;
2002000;"Powiat białostocki";158639;54140;104499;
2002000;"Powiat białostocki - URBAN-RURAL GMINAS";112078;54140;57938;
2002013;"Choroszcz (3)";18344;6162;12182;
2002014;"Choroszcz - urban area (4)";6162;6162;0;
2002015;"Choroszcz - rural area (5)";12182;0;12182;
2002023;"Czarna Białostocka (3)";10562;8512;2050;
2002024;"Czarna Białostocka - urban area (4)";8512;8512;0;
2002025;"Czarna Białostocka - rural area (5)";2050;0;2050;
2002032;"Dobrzyniewo Duże (2)";10477;0;10477;
2002042;"Gródek (2)";4826;0;4826;
2002052;"Juchnowiec Kościelny (2)";18633;0;18633;
2002063;"Łapy (3)";20160;14333;5827;
2002064;"Łapy - urban area (4)";14333;14333;0;
2002065;"Łapy - rural area (5)";5827;0;5827;
2002073;"Michałowo (3)";5842;2750;3092;
2002074;"Michałowo - urban area (4)";2750;2750;0;
2002075;"Michałowo - rural area (5)";3092;0;3092;
2002082;"Poświętne (2)";3057;0;3057;
2002093;"Supraśl (3)";18423;4325;14098;
2002094;"Supraśl - urban area (4)";4325;4325;0;
2002095;"Supraśl - rural area (5)";14098;0;14098;
2002103;"Suraż (3)";1904;964;940;
2002104;"Suraż - urban area (4)";964;964;0;
2002105;"Suraż - rural area (5)";940;0;940;
2002112;"Turośń Kościelna (2)";7121;0;7121;
2002123;"Tykocin (3)";5617;1828;3789;
2002124;"Tykocin - urban area (4)";1828;1828;0;
2002125;"Tykocin - rural area (5)";3789;0;3789;
2002133;"Wasilków (3)";21148;12790;8358;
2002134;"Wasilków - urban area (4)";12790;12790;0;
2002135;"Wasilków - rural area (5)";8358;0;8358;
2002143;"Zabłudów (3)";10078;2476;7602;
2002144;"Zabłudów - urban area (4)";2476;2476;0;
2002145;"Zabłudów - rural area (5)";7602;0;7602;
2002152;"Zawady (2)";2447;0;2447;
2003000;"Powiat bielski";50268;27144;23124;
2003000;"Powiat bielski - URBAN GMINAS";27144;27144;0;
2003011;"Bielsk Podlaski (1)";23677;23677;0;
2003021;"Brańsk (1)";3467;3467;0;
2003032;"Bielsk Podlaski (2)";6391;0;6391;
2003042;"Boćki (2)";3768;0;3768;
2003052;"Brańsk (2)";5104;0;5104;
2003062;"Orla (2)";2395;0;2395;
2003072;"Rudka (2)";1642;0;1642;
2003082;"Wyszki (2)";3824;0;3824;
2004000;"Powiat grajewski";44011;25301;18710;
2004000;"Powiat grajewski - URBAN GMINAS";20777;20777;0;
2004000;"Powiat grajewski - URBAN-RURAL GMINAS";10246;4524;5722;
2004011;"Grajewo (1)";20777;20777;0;
2004022;"Grajewo (2)";5457;0;5457;
2004032;"Radziłów (2)";4257;0;4257;
2004043;"Rajgród (3)";4570;1401;3169;
2004044;"Rajgród - urban area (4)";1401;1401;0;
2004045;"Rajgród - rural area (5)";3169;0;3169;
2004053;"Szczuczyn (3)";5676;3123;2553;
2004054;"Szczuczyn - urban area (4)";3123;3123;0;
2004055;"Szczuczyn - rural area (5)";2553;0;2553;
2004062;"Wąsosz (2)";3274;0;3274;
2005000;"Powiat hajnowski";38527;19883;18644;
2005000;"Powiat hajnowski - URBAN GMINAS";18836;18836;0;
2005000;"Powiat hajnowski - URBAN-RURAL GMINAS";2092;1047;1045;
2005011;"Hajnówka (1)";18836;18836;0;
2005022;"Białowieża (2)";2042;0;2042;
2005032;"Czeremcha (2)";2634;0;2634;
2005042;"Czyże (2)";1739;0;1739;
2005052;"Dubicze Cerkiewne (2)";1295;0;1295;
2005062;"Hajnówka (2)";3613;0;3613;
2005073;"Kleszczele (3)";2092;1047;1045;
2005074;"Kleszczele - urban area (4)";1047;1047;0;
2005075;"Kleszczele - rural area (5)";1045;0;1045;
2005082;"Narew (2)";3180;0;3180;
2005092;"Narewka (2)";3096;0;3096;
2006000;"Powiat kolneński";35510;11796;23714;
2006000;"Powiat kolneński - URBAN GMINAS";9805;9805;0;
2006000;"Powiat kolneński - URBAN-RURAL GMINAS";5512;1991;3521;
2006011;"Kolno (1)";9805;9805;0;
2006022;"Grabowo (2)";3189;0;3189;
2006032;"Kolno (2)";7848;0;7848;
2006042;"Mały Płock (2)";4383;0;4383;
2006053;"Stawiski (3)";5512;1991;3521;
2006054;"Stawiski - urban area (4)";1991;1991;0;
2006055;"Stawiski - rural area (5)";3521;0;3521;
2006062;"Turośl (2)";4773;0;4773;
2007000;"Powiat łomżyński";49575;3761;45814;
2007000;"Powiat łomżyński - URBAN-RURAL GMINAS";8691;3761;4930;
2007013;"Jedwabne (3)";4839;1668;3171;
2007014;"Jedwabne - urban area (4)";1668;1668;0;
2007015;"Jedwabne - rural area (5)";3171;0;3171;
2007022;"Łomża (2)";12182;0;12182;
2007032;"Miastkowo (2)";3971;0;3971;
2007043;"Nowogród (3)";3852;2093;1759;
2007044;"Nowogród - urban area (4)";2093;2093;0;
2007045;"Nowogród - rural area (5)";1759;0;1759;
2007052;"Piątnica (2)";10265;0;10265;
2007062;"Przytuły (2)";1899;0;1899;
2007072;"Śniadowo (2)";5013;0;5013;
2007082;"Wizna (2)";3613;0;3613;
2007092;"Zbójna (2)";3941;0;3941;
2008000;"Powiat moniecki";37203;13752;23451;
2008000;"Powiat moniecki - URBAN-RURAL GMINAS";22934;13752;9182;
2008013;"Goniądz (3)";4571;1714;2857;
2008014;"Goniądz - urban area (4)";1714;1714;0;
2008015;"Goniądz - rural area (5)";2857;0;2857;
2008022;"Jasionówka (2)";2440;0;2440;
2008032;"Jaświły (2)";4230;0;4230;
2008043;"Knyszyn (3)";4458;2647;1811;
2008044;"Knyszyn - urban area (4)";2647;2647;0;
2008045;"Knyszyn - rural area (5)";1811;0;1811;
2008052;"Krypno (2)";3698;0;3698;
2008063;"Mońki (3)";13905;9391;4514;
2008064;"Mońki - urban area (4)";9391;9391;0;
2008065;"Mońki - rural area (5)";4514;0;4514;
2008072;"Trzcianne (2)";3901;0;3901;
2009000;"Powiat sejneński";18527;4845;13682;
2009000;"Powiat sejneński - URBAN GMINAS";4845;4845;0;
2009011;"Sejny (1)";4845;4845;0;
2009022;"Giby (2)";2436;0;2436;
2009032;"Krasnopol (2)";3508;0;3508;
2009042;"Puńsk (2)";3945;0;3945;
2009052;"Sejny (2)";3793;0;3793;
2010000;"Powiat siemiatycki";40413;15080;25333;
2010000;"Powiat siemiatycki - URBAN GMINAS";13340;13340;0;
2010000;"Powiat siemiatycki - URBAN-RURAL GMINAS";5623;1740;3883;
2010011;"Siemiatycze (1)";13340;13340;0;
2010023;"Drohiczyn (3)";5623;1740;3883;
2010024;"Drohiczyn - urban area (4)";1740;1740;0;
2010025;"Drohiczyn - rural area (5)";3883;0;3883;
2010032;"Dziadkowice (2)";2497;0;2497;
2010042;"Grodzisk (2)";3730;0;3730;
2010052;"Mielnik (2)";2010;0;2010;
2010062;"Milejczyce (2)";1596;0;1596;
2010072;"Nurzec-Stacja (2)";3435;0;3435;
2010082;"Perlejewo (2)";2488;0;2488;
2010092;"Siemiatycze (2)";5694;0;5694;
2011000;"Powiat sokólski";60908;26102;34806;
2011000;"Powiat sokólski - URBAN-RURAL GMINAS";42649;26102;16547;
2011013;"Dąbrowa Białostocka (3)";9986;4967;5019;
2011014;"Dąbrowa Białostocka - urban area (4)";4967;4967;0;
2011015;"Dąbrowa Białostocka - rural area (5)";5019;0;5019;
2011022;"Janów (2)";3698;0;3698;
2011032;"Korycin (2)";3057;0;3057;
2011043;"Krynki (3)";2683;2122;561;
2011044;"Krynki - urban area (4)";2122;2122;0;
2011045;"Krynki - rural area (5)";561;0;561;
2011052;"Kuźnica (2)";3620;0;3620;
2011062;"Nowy Dwór (2)";2174;0;2174;
2011072;"Sidra (2)";3012;0;3012;
2011083;"Sokółka (3)";23743;16998;6745;
2011084;"Sokółka - urban area (4)";16998;16998;0;
2011085;"Sokółka - rural area (5)";6745;0;6745;
2011093;"Suchowola (3)";6237;2015;4222;
2011094;"Suchowola - urban area (4)";2015;2015;0;
2011095;"Suchowola - rural area (5)";4222;0;4222;
2011102;"Szudziałowo (2)";2698;0;2698;
2012000;"Powiat suwalski";34591;0;34591;
2012012;"Bakałarzewo (2)";2984;0;2984;
2012022;"Filipów (2)";4025;0;4025;
2012032;"Jeleniewo (2)";3090;0;3090;
2012042;"Przerośl (2)";2725;0;2725;
2012052;"Raczki (2)";5646;0;5646;
2012062;"Rutka-Tartak (2)";2196;0;2196;
2012072;"Suwałki (2)";8122;0;8122;
2012082;"Szypliszki (2)";3858;0;3858;
2012092;"Wiżajny (2)";1945;0;1945;
2013000;"Powiat wysokomazowiecki";53120;17793;35327;
2013000;"Powiat wysokomazowiecki - URBAN GMINAS";8997;8997;0;
2013000;"Powiat wysokomazowiecki - URBAN-RURAL GMINAS";20204;8796;11408;
2013011;"Wysokie Mazowieckie (1)";8997;8997;0;
2013023;"Ciechanowiec (3)";7898;4340;3558;
2013024;"Ciechanowiec - urban area (4)";4340;4340;0;
2013025;"Ciechanowiec - rural area (5)";3558;0;3558;
2013033;"Czyżew (3)";5952;2457;3495;
2013034;"Czyżew - urban area (4)";2457;2457;0;
2013035;"Czyżew - rural area (5)";3495;0;3495;
2013042;"Klukowo (2)";3916;0;3916;
2013052;"Kobylin-Borzymy (2)";2918;0;2918;
2013062;"Kulesze Kościelne (2)";2898;0;2898;
2013072;"Nowe Piekuty (2)";3552;0;3552;
2013082;"Sokoły (2)";5167;0;5167;
2013093;"Szepietowo (3)";6354;1999;4355;
2013094;"Szepietowo - urban area (4)";1999;1999;0;
2013095;"Szepietowo - rural area (5)";4355;0;4355;
2013102;"Wysokie Mazowieckie (2)";5468;0;5468;
2014000;"Powiat zambrowski";41246;20777;20469;
2014000;"Powiat zambrowski - URBAN GMINAS";20777;20777;0;
2014011;"Zambrów (1)";20777;20777;0;
2014022;"Kołaki Kościelne (2)";2151;0;2151;
2014032;"Rutki (2)";5036;0;5036;
2014042;"Szumowo (2)";4535;0;4535;
2014052;"Zambrów (2)";8747;0;8747;
2061000;"City with powiat status Białystok";290907;290907;0;
2061000;"City with powiat status Białystok - URBAN GMINAS";290907;290907;0;
2061011;"Białystok (1)";290907;290907;0;
2062000;"City with powiat status Łomża";59476;59476;0;
2062000;"City with powiat status Łomża - URBAN GMINAS";59476;59476;0;
2062011;"Łomża (1)";59476;59476;0;
2063000;"City with powiat status Suwałki";68035;68035;0;
2063000;"City with powiat status Suwałki - URBAN GMINAS";68035;68035;0;
2063011;"Suwałki (1)";68035;68035;0;
2201000;"Powiat bytowski";76302;25501;50801;
2201000;"Powiat bytowski - URBAN-RURAL GMINAS";42612;25501;17111;
2201012;"Borzytuchom (2)";3554;0;3554;
2201023;"Bytów (3)";24897;16218;8679;
2201024;"Bytów - urban area (4)";16218;16218;0;
2201025;"Bytów - rural area (5)";8679;0;8679;
2201032;"Czarna Dąbrówka (2)";5661;0;5661;
2201042;"Kołczygłowy (2)";4086;0;4086;
2201052;"Lipnica (2)";5184;0;5184;
2201063;"Miastko (3)";17715;9283;8432;
2201064;"Miastko - urban area (4)";9283;9283;0;
2201065;"Miastko - rural area (5)";8432;0;8432;
2201072;"Parchowo (2)";3855;0;3855;
2201082;"Studzienice (2)";3666;0;3666;
2201092;"Trzebielino (2)";3508;0;3508;
2201102;"Tuchomie (2)";4176;0;4176;
2202000;"Powiat chojnicki";95759;53404;42355;
2202000;"Powiat chojnicki - URBAN GMINAS";38508;38508;0;
2202000;"Powiat chojnicki - URBAN-RURAL GMINAS";35483;14896;20587;
2202011;"Chojnice (1)";38508;38508;0;
2202023;"Brusy (3)";14245;5053;9192;
2202024;"Brusy - urban area (4)";5053;5053;0;
2202025;"Brusy - rural area (5)";9192;0;9192;
2202032;"Chojnice (2)";19530;0;19530;
2202043;"Czersk (3)";21238;9843;11395;
2202044;"Czersk - urban area (4)";9843;9843;0;
2202045;"Czersk - rural area (5)";11395;0;11395;
2202052;"Konarzyny (2)";2238;0;2238;
2203000;"Powiat człuchowski";52978;23310;29668;
2203000;"Powiat człuchowski - URBAN GMINAS";12958;12958;0;
2203000;"Powiat człuchowski - URBAN-RURAL GMINAS";16943;10352;6591;
2203011;"Człuchów (1)";12958;12958;0;
2203023;"Czarne (3)";8483;5547;2936;
2203024;"Czarne - urban area (4)";5547;5547;0;
2203025;"Czarne - rural area (5)";2936;0;2936;
2203032;"Człuchów (2)";10832;0;10832;
2203043;"Debrzno (3)";8460;4805;3655;
2203044;"Debrzno - urban area (4)";4805;4805;0;
2203045;"Debrzno - rural area (5)";3655;0;3655;
2203052;"Koczała (2)";3113;0;3113;
2203062;"Przechlewo (2)";5803;0;5803;
2203072;"Rzeczenica (2)";3329;0;3329;
2204000;"Powiat gdański";132802;32270;100532;
2204000;"Powiat gdański - URBAN GMINAS";32270;32270;0;
2204011;"Pruszcz Gdański (1)";32270;32270;0;
2204022;"Cedry Wielkie (2)";6838;0;6838;
2204032;"Kolbudy (2)";21510;0;21510;
2204042;"Pruszcz Gdański (2)";38262;0;38262;
2204052;"Przywidz (2)";6179;0;6179;
2204062;"Pszczółki (2)";11281;0;11281;
2204072;"Suchy Dąb (2)";4240;0;4240;
2204082;"Trąbki Wielkie (2)";12222;0;12222;
2205000;"Powiat kartuski";154695;20410;134285;
2205000;"Powiat kartuski - URBAN-RURAL GMINAS";85905;20410;65495;
2205012;"Chmielno (2)";7787;0;7787;
2205023;"Kartuzy (3)";34328;13687;20641;
2205024;"Kartuzy - urban area (4)";13687;13687;0;
2205025;"Kartuzy - rural area (5)";20641;0;20641;
2205032;"Przodkowo (2)";11490;0;11490;
2205042;"Sierakowice (2)";21005;0;21005;
2205052;"Somonino (2)";11324;0;11324;
2205062;"Stężyca (2)";11456;0;11456;
2205072;"Sulęczyno (2)";5728;0;5728;
2205083;"Żukowo (3)";51577;6723;44854;
2205084;"Żukowo - urban area (4)";6723;6723;0;
2205085;"Żukowo - rural area (5)";44854;0;44854;
2206000;"Powiat kościerski";72201;23353;48848;
2206000;"Powiat kościerski - URBAN GMINAS";23353;23353;0;
2206011;"Kościerzyna (1)";23353;23353;0;
2206022;"Dziemiany (2)";4463;0;4463;
2206032;"Karsin (2)";6113;0;6113;
2206042;"Kościerzyna (2)";16082;0;16082;
2206052;"Liniewo (2)";4456;0;4456;
2206062;"Lipusz (2)";3745;0;3745;
2206072;"Nowa Karczma (2)";7291;0;7291;
2206082;"Stara Kiszewa (2)";6698;0;6698;
2207000;"Powiat kwidzyński";79941;44784;35157;
2207000;"Powiat kwidzyński - URBAN GMINAS";36731;36731;0;
2207000;"Powiat kwidzyński - URBAN-RURAL GMINAS";12192;8053;4139;
2207011;"Kwidzyn (1)";36731;36731;0;
2207022;"Gardeja (2)";8061;0;8061;
2207032;"Kwidzyn (2)";11445;0;11445;
2207043;"Prabuty (3)";12192;8053;4139;
2207044;"Prabuty - urban area (4)";8053;8053;0;
2207045;"Prabuty - rural area (5)";4139;0;4139;
2207052;"Ryjewo (2)";5558;0;5558;
2207062;"Sadlinki (2)";5954;0;5954;
2208000;"Powiat lęborski";63576;36894;26682;
2208000;"Powiat lęborski - URBAN GMINAS";36894;36894;0;
2208011;"Lębork (1)";33865;33865;0;
2208021;"Łeba (1)";3029;3029;0;
2208032;"Cewice (2)";7487;0;7487;
2208042;"Nowa Wieś Lęborska (2)";13702;0;13702;
2208052;"Wicko (2)";5493;0;5493;
2209000;"Powiat malborski";60438;40525;19913;
2209000;"Powiat malborski - URBAN GMINAS";36573;36573;0;
2209000;"Powiat malborski - URBAN-RURAL GMINAS";6989;3952;3037;
2209011;"Malbork (1)";36573;36573;0;
2209032;"Lichnowy (2)";4203;0;4203;
2209042;"Malbork (2)";5129;0;5129;
2209062;"Miłoradz (2)";3221;0;3221;
2209073;"Nowy Staw (3)";6989;3952;3037;
2209074;"Nowy Staw - urban area (4)";3952;3952;0;
2209075;"Nowy Staw - rural area (5)";3037;0;3037;
2209082;"Stare Pole (2)";4323;0;4323;
2210000;"Powiat nowodworski";33513;10594;22919;
2210000;"Powiat nowodworski - URBAN GMINAS";1159;1159;0;
2210000;"Powiat nowodworski - URBAN-RURAL GMINAS";16827;9435;7392;
2210011;"Krynica Morska (1)";1159;1159;0;
2210023;"Nowy Dwór Gdański (3)";16827;9435;7392;
2210024;"Nowy Dwór Gdański - urban area (4)";9435;9435;0;
2210025;"Nowy Dwór Gdański - rural area (5)";7392;0;7392;
2210032;"Ostaszewo (2)";2912;0;2912;
2210042;"Stegna (2)";9210;0;9210;
2210052;"Sztutowo (2)";3405;0;3405;
2211000;"Powiat pucki";92154;24909;67245;
2211000;"Powiat pucki - URBAN GMINAS";13174;13174;0;
2211000;"Powiat pucki - URBAN-RURAL GMINAS";17623;11735;5888;
2211011;"Hel (1)";2755;2755;0;
2211023;"Jastarnia (3)";3447;2581;866;
2211024;"Jastarnia - urban area (4)";2581;2581;0;
2211025;"Jastarnia - rural area (5)";866;0;866;
2211031;"Puck (1)";10419;10419;0;
2211043;"Władysławowo (3)";14176;9154;5022;
2211044;"Władysławowo - urban area (4)";9154;9154;0;
2211045;"Władysławowo - rural area (5)";5022;0;5022;
2211052;"Kosakowo (2)";21954;0;21954;
2211062;"Krokowa (2)";10522;0;10522;
2211072;"Puck (2)";28881;0;28881;
2212000;"Powiat słupski";96140;16828;79312;
2212000;"Powiat słupski - URBAN GMINAS";13574;13574;0;
2212000;"Powiat słupski - URBAN-RURAL GMINAS";8110;3254;4856;
2212011;"Ustka (1)";13574;13574;0;
2212022;"Damnica (2)";5589;0;5589;
2212032;"Dębnica Kaszubska (2)";8957;0;8957;
2212042;"Główczyce (2)";8202;0;8202;
2212053;"Kępice (3)";8110;3254;4856;
2212054;"Kępice - urban area (4)";3254;3254;0;
2212055;"Kępice - rural area (5)";4856;0;4856;
2212062;"Kobylnica (2)";14442;0;14442;
2212072;"Potęgowo (2)";6456;0;6456;
2212082;"Redzikowo (2)";19707;0;19707;
2212092;"Smołdzino (2)";3052;0;3052;
2212102;"Ustka (2)";8051;0;8051;
2213000;"Powiat starogardzki";124979;57836;67143;
2213000;"Powiat starogardzki - URBAN GMINAS";48606;48606;0;
2213000;"Powiat starogardzki - URBAN-RURAL GMINAS";17508;9230;8278;
2213013;"Czarna Woda (3)";3008;2643;365;
2213014;"Czarna Woda - urban area (4)";2643;2643;0;
2213015;"Czarna Woda - rural area (5)";365;0;365;
2213021;"Skórcz (1)";3422;3422;0;
2213031;"Starogard Gdański (1)";45184;45184;0;
2213042;"Bobowo (2)";3176;0;3176;
2213052;"Kaliska (2)";5287;0;5287;
2213062;"Lubichowo (2)";6909;0;6909;
2213072;"Osieczna (2)";2669;0;2669;
2213082;"Osiek (2)";2258;0;2258;
2213093;"Skarszewy (3)";14500;6587;7913;
2213094;"Skarszewy - urban area (4)";6587;6587;0;
2213095;"Skarszewy - rural area (5)";7913;0;7913;
2213102;"Skórcz (2)";4279;0;4279;
2213112;"Smętowo Graniczne (2)";4795;0;4795;
2213122;"Starogard Gdański (2)";17267;0;17267;
2213132;"Zblewo (2)";12225;0;12225;
2214000;"Powiat tczewski";110865;69892;40973;
2214000;"Powiat tczewski - URBAN GMINAS";56676;56676;0;
2214000;"Powiat tczewski - URBAN-RURAL GMINAS";29231;13216;16015;
2214011;"Tczew (1)";56676;56676;0;
2214023;"Gniew (3)";14230;6098;8132;
2214024;"Gniew - urban area (4)";6098;6098;0;
2214025;"Gniew - rural area (5)";8132;0;8132;
2214032;"Morzeszczyn (2)";3284;0;3284;
2214043;"Pelplin (3)";15001;7118;7883;
2214044;"Pelplin - urban area (4)";7118;7118;0;
2214045;"Pelplin - rural area (5)";7883;0;7883;
2214052;"Subkowy (2)";5337;0;5337;
2214062;"Tczew (2)";16337;0;16337;
2215000;"Powiat wejherowski";230301;128185;102116;
2215000;"Powiat wejherowski - URBAN GMINAS";128185;128185;0;
2215011;"Reda (1)";28866;28866;0;
2215021;"Rumia (1)";53585;53585;0;
2215031;"Wejherowo (1)";45734;45734;0;
2215042;"Choczewo (2)";4904;0;4904;
2215052;"Gniewino (2)";7416;0;7416;
2215062;"Linia (2)";6460;0;6460;
2215072;"Luzino (2)";18102;0;18102;
2215082;"Łęczyce (2)";11936;0;11936;
2215092;"Szemud (2)";21953;0;21953;
2215102;"Wejherowo (2)";31345;0;31345;
2216000;"Powiat sztumski";38093;13835;24258;
2216000;"Powiat sztumski - URBAN-RURAL GMINAS";25444;13835;11609;
2216013;"Dzierzgoń (3)";8584;4850;3734;
2216014;"Dzierzgoń - urban area (4)";4850;4850;0;
2216015;"Dzierzgoń - rural area (5)";3734;0;3734;
2216022;"Mikołajki Pomorskie (2)";3352;0;3352;
2216032;"Stary Dzierzgoń (2)";3432;0;3432;
2216042;"Stary Targ (2)";5865;0;5865;
2216053;"Sztum (3)";16860;8985;7875;
2216054;"Sztum - urban area (4)";8985;8985;0;
2216055;"Sztum - rural area (5)";7875;0;7875;
2261000;"City with powiat status Gdańsk";487834;487834;0;
2261000;"City with powiat status Gdańsk - URBAN GMINAS";487834;487834;0;
2261011;"Gdańsk (1)";487834;487834;0;
2262000;"City with powiat status Gdynia";240554;240554;0;
2262000;"City with powiat status Gdynia - URBAN GMINAS";240554;240554;0;
2262011;"Gdynia (1)";240554;240554;0;
2263000;"City with powiat status Słupsk";85135;85135;0;
2263000;"City with powiat status Słupsk - URBAN GMINAS";85135;85135;0;
2263011;"Słupsk (1)";85135;85135;0;
2264000;"City with powiat status Sopot";31696;31696;0;
2264000;"City with powiat status Sopot - URBAN GMINAS";31696;31696;0;
2264011;"Sopot (1)";31696;31696;0;
2401000;"Powiat będziński";144192;104264;39928;
2401000;"Powiat będziński - URBAN GMINAS";98486;98486;0;
2401000;"Powiat będziński - URBAN-RURAL GMINAS";12796;5778;7018;
2401011;"Będzin (1)";53586;53586;0;
2401021;"Czeladź (1)";29666;29666;0;
2401031;"Wojkowice (1)";8437;8437;0;
2401042;"Bobrowniki (2)";12565;0;12565;
2401052;"Mierzęcice (2)";7997;0;7997;
2401062;"Psary (2)";12348;0;12348;
2401073;"Siewierz (3)";12796;5778;7018;
2401074;"Siewierz - urban area (4)";5778;5778;0;
2401075;"Siewierz - rural area (5)";7018;0;7018;
2401081;"Sławków (1)";6797;6797;0;
2402000;"Powiat bielski";165829;43133;122696;
2402000;"Powiat bielski - URBAN GMINAS";5261;5261;0;
2402000;"Powiat bielski - URBAN-RURAL GMINAS";62616;37872;24744;
2402011;"Szczyrk (1)";5261;5261;0;
2402022;"Bestwina (2)";12279;0;12279;
2402032;"Buczkowice (2)";11157;0;11157;
2402043;"Czechowice-Dziedzice (3)";44337;34686;9651;
2402044;"Czechowice-Dziedzice - urban area (4)";34686;34686;0;
2402045;"Czechowice-Dziedzice - rural area (5)";9651;0;9651;
2402052;"Jasienica (2)";25231;0;25231;
2402062;"Jaworze (2)";7411;0;7411;
2402072;"Kozy (2)";13193;0;13193;
2402082;"Porąbka (2)";15430;0;15430;
2402093;"Wilamowice (3)";18279;3186;15093;
2402094;"Wilamowice - urban area (4)";3186;3186;0;
2402095;"Wilamowice - rural area (5)";15093;0;15093;
2402102;"Wilkowice (2)";13251;0;13251;
2403000;"Powiat cieszyński";174189;76018;98171;
2403000;"Powiat cieszyński - URBAN GMINAS";59157;59157;0;
2403000;"Powiat cieszyński - URBAN-RURAL GMINAS";39270;16861;22409;
2403011;"Cieszyn (1)";32760;32760;0;
2403021;"Ustroń (1)";15845;15845;0;
2403031;"Wisła (1)";10552;10552;0;
2403042;"Brenna (2)";11725;0;11725;
2403052;"Chybie (2)";9614;0;9614;
2403062;"Dębowiec (2)";5788;0;5788;
2403072;"Goleszów (2)";13076;0;13076;
2403082;"Hażlach (2)";10722;0;10722;
2403092;"Istebna (2)";12199;0;12199;
2403103;"Skoczów (3)";26094;13319;12775;
2403104;"Skoczów - urban area (4)";13319;13319;0;
2403105;"Skoczów - rural area (5)";12775;0;12775;
2403113;"Strumień (3)";13176;3542;9634;
2403114;"Strumień - urban area (4)";3542;3542;0;
2403115;"Strumień - rural area (5)";9634;0;9634;
2403122;"Zebrzydowice (2)";12638;0;12638;
2404000;"Powiat częstochowski";131333;17875;113458;
2404000;"Powiat częstochowski - URBAN-RURAL GMINAS";32722;17875;14847;
2404013;"Blachownia (3)";12377;8981;3396;
2404014;"Blachownia - urban area (4)";8981;8981;0;
2404015;"Blachownia - rural area (5)";3396;0;3396;
2404022;"Dąbrowa Zielona (2)";3625;0;3625;
2404032;"Janów (2)";5816;0;5816;
2404042;"Kamienica Polska (2)";5392;0;5392;
2404052;"Kłomnice (2)";12800;0;12800;
2404063;"Koniecpol (3)";8573;5318;3255;
2404064;"Koniecpol - urban area (4)";5318;5318;0;
2404065;"Koniecpol - rural area (5)";3255;0;3255;
2404072;"Konopiska (2)";10873;0;10873;
2404082;"Kruszyna (2)";4656;0;4656;
2404092;"Lelów (2)";4479;0;4479;
2404102;"Mstów (2)";10826;0;10826;
2404112;"Mykanów (2)";15391;0;15391;
2404123;"Olsztyn (3)";8249;2491;5758;
2404124;"Olsztyn - urban area (4)";2491;2491;0;
2404125;"Olsztyn - rural area (5)";5758;0;5758;
2404132;"Poczesna (2)";12393;0;12393;
2404143;"Przyrów (3)";3523;1085;2438;
2404144;"Przyrów - urban area (4)";1085;1085;0;
2404145;"Przyrów - rural area (5)";2438;0;2438;
2404152;"Rędziny (2)";9443;0;9443;
2404162;"Starcza (2)";2917;0;2917;
2405000;"Powiat gliwicki";113125;58104;55021;
2405000;"Powiat gliwicki - URBAN GMINAS";52652;52652;0;
2405000;"Powiat gliwicki - URBAN-RURAL GMINAS";18334;5452;12882;
2405011;"Knurów (1)";35422;35422;0;
2405021;"Pyskowice (1)";17230;17230;0;
2405032;"Gierałtowice (2)";12743;0;12743;
2405042;"Pilchowice (2)";12789;0;12789;
2405052;"Rudziniec (2)";10840;0;10840;
2405063;"Sośnicowice (3)";9081;1963;7118;
2405064;"Sośnicowice - urban area (4)";1963;1963;0;
2405065;"Sośnicowice - rural area (5)";7118;0;7118;
2405073;"Toszek (3)";9253;3489;5764;
2405074;"Toszek - urban area (4)";3489;3489;0;
2405075;"Toszek - rural area (5)";5764;0;5764;
2405082;"Wielowieś (2)";5767;0;5767;
2406000;"Powiat kłobucki";81720;16271;65449;
2406000;"Powiat kłobucki - URBAN-RURAL GMINAS";28084;16271;11813;
2406013;"Kłobuck (3)";19589;12180;7409;
2406014;"Kłobuck - urban area (4)";12180;12180;0;
2406015;"Kłobuck - rural area (5)";7409;0;7409;
2406023;"Krzepice (3)";8495;4091;4404;
2406024;"Krzepice - urban area (4)";4091;4091;0;
2406025;"Krzepice - rural area (5)";4404;0;4404;
2406032;"Lipie (2)";5928;0;5928;
2406042;"Miedźno (2)";7403;0;7403;
2406052;"Opatów (2)";6595;0;6595;
2406062;"Panki (2)";4797;0;4797;
2406072;"Popów (2)";5667;0;5667;
2406082;"Przystajń (2)";5693;0;5693;
2406092;"Wręczyca Wielka (2)";17553;0;17553;
2407000;"Powiat lubliniecki";74665;27345;47320;
2407000;"Powiat lubliniecki - URBAN GMINAS";23245;23245;0;
2407000;"Powiat lubliniecki - URBAN-RURAL GMINAS";9316;4100;5216;
2407011;"Lubliniec (1)";23245;23245;0;
2407022;"Boronów (2)";3334;0;3334;
2407032;"Ciasna (2)";7187;0;7187;
2407042;"Herby (2)";6363;0;6363;
2407052;"Kochanowice (2)";6946;0;6946;
2407062;"Koszęcin (2)";11807;0;11807;
2407072;"Pawonków (2)";6467;0;6467;
2407083;"Woźniki (3)";9316;4100;5216;
2407084;"Woźniki - urban area (4)";4100;4100;0;
2407085;"Woźniki - rural area (5)";5216;0;5216;
2408000;"Powiat mikołowski";100137;84798;15339;
2408000;"Powiat mikołowski - URBAN GMINAS";84798;84798;0;
2408011;"Łaziska Górne (1)";21029;21029;0;
2408021;"Mikołów (1)";41678;41678;0;
2408031;"Orzesze (1)";22091;22091;0;
2408042;"Ornontowice (2)";6210;0;6210;
2408052;"Wyry (2)";9129;0;9129;
2409000;"Powiat myszkowski";67310;35856;31454;
2409000;"Powiat myszkowski - URBAN GMINAS";29154;29154;0;
2409000;"Powiat myszkowski - URBAN-RURAL GMINAS";22253;6702;15551;
2409011;"Myszków (1)";29154;29154;0;
2409023;"Koziegłowy (3)";14113;2376;11737;
2409024;"Koziegłowy - urban area (4)";2376;2376;0;
2409025;"Koziegłowy - rural area (5)";11737;0;11737;
2409032;"Niegowa (2)";5350;0;5350;
2409042;"Poraj (2)";10553;0;10553;
2409053;"Żarki (3)";8140;4326;3814;
2409054;"Żarki - urban area (4)";4326;4326;0;
2409055;"Żarki - rural area (5)";3814;0;3814;
2410000;"Powiat pszczyński";110786;24834;85952;
2410000;"Powiat pszczyński - URBAN-RURAL GMINAS";52648;24834;27814;
2410012;"Goczałkowice-Zdrój (2)";6643;0;6643;
2410022;"Kobiór (2)";5118;0;5118;
2410032;"Miedźna (2)";16085;0;16085;
2410042;"Pawłowice (2)";17515;0;17515;
2410053;"Pszczyna (3)";52648;24834;27814;
2410054;"Pszczyna - urban area (4)";24834;24834;0;
2410055;"Pszczyna - rural area (5)";27814;0;27814;
2410062;"Suszec (2)";12777;0;12777;
2411000;"Powiat raciborski";98954;55928;43026;
2411000;"Powiat raciborski - URBAN GMINAS";49360;49360;0;
2411000;"Powiat raciborski - URBAN-RURAL GMINAS";15793;6568;9225;
2411011;"Racibórz (1)";49360;49360;0;
2411022;"Kornowac (2)";5159;0;5159;
2411033;"Krzanowice (3)";5245;1985;3260;
2411034;"Krzanowice - urban area (4)";1985;1985;0;
2411035;"Krzanowice - rural area (5)";3260;0;3260;
2411042;"Krzyżanowice (2)";10655;0;10655;
2411053;"Kuźnia Raciborska (3)";10548;4583;5965;
2411054;"Kuźnia Raciborska - urban area (4)";4583;4583;0;
2411055;"Kuźnia Raciborska - rural area (5)";5965;0;5965;
2411062;"Nędza (2)";6659;0;6659;
2411072;"Pietrowice Wielkie (2)";6535;0;6535;
2411082;"Rudnik (2)";4793;0;4793;
2412000;"Powiat rybnicki";76430;26382;50048;
2412000;"Powiat rybnicki - URBAN-RURAL GMINAS";39967;26382;13585;
2412013;"Czerwionka-Leszczyny (3)";39967;26382;13585;
2412014;"Czerwionka-Leszczyny - urban area (4)";26382;26382;0;
2412015;"Czerwionka-Leszczyny - rural area (5)";13585;0;13585;
2412022;"Gaszowice (2)";9887;0;9887;
2412032;"Jejkowice (2)";4172;0;4172;
2412042;"Lyski (2)";9757;0;9757;
2412052;"Świerklany (2)";12647;0;12647;
2413000;"Powiat tarnogórski";139101;92315;46786;
2413000;"Powiat tarnogórski - URBAN GMINAS";92315;92315;0;
2413011;"Kalety (1)";8136;8136;0;
2413021;"Miasteczko Śląskie (1)";6919;6919;0;
2413031;"Radzionków (1)";16020;16020;0;
2413041;"Tarnowskie Góry (1)";61240;61240;0;
2413052;"Krupski Młyn (2)";2988;0;2988;
2413062;"Ożarowice (2)";5938;0;5938;
2413072;"Świerklaniec (2)";13201;0;13201;
2413082;"Tworóg (2)";8231;0;8231;
2413092;"Zbrosławice (2)";16428;0;16428;
2414000;"Powiat bieruńsko-lędziński";59511;44528;14983;
2414000;"Powiat bieruńsko-lędziński - URBAN GMINAS";44528;44528;0;
2414011;"Bieruń (1)";18806;18806;0;
2414021;"Imielin (1)";9419;9419;0;
2414031;"Lędziny (1)";16303;16303;0;
2414042;"Bojszowy (2)";8652;0;8652;
2414052;"Chełm Śląski (2)";6331;0;6331;
2415000;"Powiat wodzisławski";149849;94394;55455;
2415000;"Powiat wodzisławski - URBAN GMINAS";94394;94394;0;
2415011;"Pszów (1)";12976;12976;0;
2415021;"Radlin (1)";16781;16781;0;
2415031;"Rydułtowy (1)";20056;20056;0;
2415041;"Wodzisław Śląski (1)";44581;44581;0;
2415052;"Godów (2)";13713;0;13713;
2415062;"Gorzyce (2)";21152;0;21152;
2415072;"Lubomia (2)";7618;0;7618;
2415082;"Marklowice (2)";5353;0;5353;
2415092;"Mszana (2)";7619;0;7619;
2416000;"Powiat zawierciański";111041;70450;40591;
2416000;"Powiat zawierciański - URBAN GMINAS";53872;53872;0;
2416000;"Powiat zawierciański - URBAN-RURAL GMINAS";44239;16578;27661;
2416011;"Poręba (1)";8061;8061;0;
2416021;"Zawiercie (1)";45811;45811;0;
2416032;"Irządze (2)";2503;0;2503;
2416042;"Kroczyce (2)";6023;0;6023;
2416053;"Łazy (3)";15526;6320;9206;
2416054;"Łazy - urban area (4)";6320;6320;0;
2416055;"Łazy - rural area (5)";9206;0;9206;
2416063;"Ogrodzieniec (3)";8772;4043;4729;
2416064;"Ogrodzieniec - urban area (4)";4043;4043;0;
2416065;"Ogrodzieniec - rural area (5)";4729;0;4729;
2416073;"Pilica (3)";7982;1743;6239;
2416074;"Pilica - urban area (4)";1743;1743;0;
2416075;"Pilica - rural area (5)";6239;0;6239;
2416083;"Szczekociny (3)";6838;3306;3532;
2416084;"Szczekociny - urban area (4)";3306;3306;0;
2416085;"Szczekociny - rural area (5)";3532;0;3532;
2416093;"Włodowice (3)";5121;1166;3955;
2416094;"Włodowice - urban area (4)";1166;1166;0;
2416095;"Włodowice - rural area (5)";3955;0;3955;
2416102;"Żarnowiec (2)";4404;0;4404;
2417000;"Powiat żywiecki";148494;29598;118896;
2417000;"Powiat żywiecki - URBAN GMINAS";29598;29598;0;
2417011;"Żywiec (1)";29598;29598;0;
2417022;"Czernichów (2)";6307;0;6307;
2417032;"Gilowice (2)";6266;0;6266;
2417042;"Jeleśnia (2)";12534;0;12534;
2417052;"Koszarawa (2)";2213;0;2213;
2417062;"Lipowa (2)";10984;0;10984;
2417072;"Łękawica (2)";4528;0;4528;
2417082;"Łodygowice (2)";15352;0;15352;
2417092;"Milówka (2)";9753;0;9753;
2417102;"Radziechowy-Wieprz (2)";12881;0;12881;
2417112;"Rajcza (2)";8263;0;8263;
2417122;"Ślemień (2)";3499;0;3499;
2417132;"Świnna (2)";7838;0;7838;
2417142;"Ujsoły (2)";4151;0;4151;
2417152;"Węgierska Górka (2)";14327;0;14327;
2461000;"City with powiat status Bielsko-Biała";165127;165127;0;
2461000;"City with powiat status Bielsko-Biała - URBAN GMINAS";165127;165127;0;
2461011;"Bielsko-Biała (1)";165127;165127;0;
2462000;"City with powiat status Bytom";146922;146922;0;
2462000;"City with powiat status Bytom - URBAN GMINAS";146922;146922;0;
2462011;"Bytom (1)";146922;146922;0;
2463000;"City with powiat status Chorzów";100012;100012;0;
2463000;"City with powiat status Chorzów - URBAN GMINAS";100012;100012;0;
2463011;"Chorzów (1)";100012;100012;0;
2464000;"City with powiat status Częstochowa";204730;204730;0;
2464000;"City with powiat status Częstochowa - URBAN GMINAS";204730;204730;0;
2464011;"Częstochowa (1)";204730;204730;0;
2465000;"City with powiat status Dąbrowa Górnicza";112876;112876;0;
2465000;"City with powiat status Dąbrowa Górnicza - URBAN GMINAS";112876;112876;0;
2465011;"Dąbrowa Górnicza (1)";112876;112876;0;
2466000;"City with powiat status Gliwice";169259;169259;0;
2466000;"City with powiat status Gliwice - URBAN GMINAS";169259;169259;0;
2466011;"Gliwice (1)";169259;169259;0;
2467000;"City with powiat status Jastrzębie-Zdrój";81809;81809;0;
2467000;"City with powiat status Jastrzębie-Zdrój - URBAN GMINAS";81809;81809;0;
2467011;"Jastrzębie-Zdrój (1)";81809;81809;0;
2468000;"City with powiat status Jaworzno";86421;86421;0;
2468000;"City with powiat status Jaworzno - URBAN GMINAS";86421;86421;0;
2468011;"Jaworzno (1)";86421;86421;0;
2469000;"City with powiat status Katowice";278090;278090;0;
2469000;"City with powiat status Katowice - URBAN GMINAS";278090;278090;0;
2469011;"Katowice (1)";278090;278090;0;
2470000;"City with powiat status Mysłowice";71062;71062;0;
2470000;"City with powiat status Mysłowice - URBAN GMINAS";71062;71062;0;
2470011;"Mysłowice (1)";71062;71062;0;
2471000;"City with powiat status Piekary Śląskie";51565;51565;0;
2471000;"City with powiat status Piekary Śląskie - URBAN GMINAS";51565;51565;0;
2471011;"Piekary Śląskie (1)";51565;51565;0;
2472000;"City with powiat status Ruda Śląska";129531;129531;0;
2472000;"City with powiat status Ruda Śląska - URBAN GMINAS";129531;129531;0;
2472011;"Ruda Śląska (1)";129531;129531;0;
2473000;"City with powiat status Rybnik";130373;130373;0;
2473000;"City with powiat status Rybnik - URBAN GMINAS";130373;130373;0;
2473011;"Rybnik (1)";130373;130373;0;
2474000;"City with powiat status Siemianowice Śląskie";63185;63185;0;
2474000;"City with powiat status Siemianowice Śląskie - URBAN GMINAS";63185;63185;0;
2474011;"Siemianowice Śląskie (1)";63185;63185;0;
2475000;"City with powiat status Sosnowiec";185930;185930;0;
2475000;"City with powiat status Sosnowiec - URBAN GMINAS";185930;185930;0;
2475011;"Sosnowiec (1)";185930;185930;0;
2476000;"City with powiat status Świętochłowice";45215;45215;0;
2476000;"City with powiat status Świętochłowice - URBAN GMINAS";45215;45215;0;
2476011;"Świętochłowice (1)";45215;45215;0;
2477000;"City with powiat status Tychy";121472;121472;0;
2477000;"City with powiat status Tychy - URBAN GMINAS";121472;121472;0;
2477011;"Tychy (1)";121472;121472;0;
2478000;"City with powiat status Zabrze";153067;153067;0;
2478000;"City with powiat status Zabrze - URBAN GMINAS";153067;153067;0;
2478011;"Zabrze (1)";153067;153067;0;
2479000;"City with powiat status Żory";61814;61814;0;
2479000;"City with powiat status Żory - URBAN GMINAS";61814;61814;0;
2479011;"Żory (1)";61814;61814;0;
2601000;"Powiat buski";67538;17724;49814;
2601000;"Powiat buski - URBAN-RURAL GMINAS";54897;17724;37173;
2601013;"Busko-Zdrój (3)";30533;14235;16298;
2601014;"Busko-Zdrój - urban area (4)";14235;14235;0;
2601015;"Busko-Zdrój - rural area (5)";16298;0;16298;
2601022;"Gnojno (2)";4209;0;4209;
2601033;"Nowy Korczyn (3)";5424;900;4524;
2601034;"Nowy Korczyn - urban area (4)";900;900;0;
2601035;"Nowy Korczyn - rural area (5)";4524;0;4524;
2601043;"Pacanów (3)";6840;1032;5808;
2601044;"Pacanów - urban area (4)";1032;1032;0;
2601045;"Pacanów - rural area (5)";5808;0;5808;
2601052;"Solec-Zdrój (2)";4864;0;4864;
2601063;"Stopnica (3)";7025;1114;5911;
2601064;"Stopnica - urban area (4)";1114;1114;0;
2601065;"Stopnica - rural area (5)";5911;0;5911;
2601072;"Tuczępy (2)";3568;0;3568;
2601083;"Wiślica (3)";5075;443;4632;
2601084;"Wiślica - urban area (4)";443;443;0;
2601085;"Wiślica - rural area (5)";4632;0;4632;
2602000;"Powiat jędrzejowski";80682;24295;56387;
2602000;"Powiat jędrzejowski - URBAN-RURAL GMINAS";55332;24295;31037;
2602012;"Imielno (2)";4132;0;4132;
2602023;"Jędrzejów (3)";26325;13931;12394;
2602024;"Jędrzejów - urban area (4)";13931;13931;0;
2602025;"Jędrzejów - rural area (5)";12394;0;12394;
2602033;"Małogoszcz (3)";11002;3330;7672;
2602034;"Małogoszcz - urban area (4)";3330;3330;0;
2602035;"Małogoszcz - rural area (5)";7672;0;7672;
2602042;"Nagłowice (2)";4671;0;4671;
2602052;"Oksa (2)";4349;0;4349;
2602063;"Sędziszów (3)";11688;6083;5605;
2602064;"Sędziszów - urban area (4)";6083;6083;0;
2602065;"Sędziszów - rural area (5)";5605;0;5605;
2602072;"Słupia (2)";3875;0;3875;
2602082;"Sobków (2)";8323;0;8323;
2602093;"Wodzisław (3)";6317;951;5366;
2602094;"Wodzisław - urban area (4)";951;951;0;
2602095;"Wodzisław - rural area (5)";5366;0;5366;
2603000;"Powiat kazimierski";31537;6462;25075;
2603000;"Powiat kazimierski - URBAN-RURAL GMINAS";24142;6462;17680;
2603012;"Bejsce (2)";3834;0;3834;
2603022;"Czarnocin (2)";3561;0;3561;
2603033;"Kazimierza Wielka (3)";15128;4969;10159;
2603034;"Kazimierza Wielka - urban area (4)";4969;4969;0;
2603035;"Kazimierza Wielka - rural area (5)";10159;0;10159;
2603043;"Opatowiec (3)";2929;307;2622;
2603044;"Opatowiec - urban area (4)";307;307;0;
2603045;"Opatowiec - rural area (5)";2622;0;2622;
2603053;"Skalbmierz (3)";6085;1186;4899;
2603054;"Skalbmierz - urban area (4)";1186;1186;0;
2603055;"Skalbmierz - rural area (5)";4899;0;4899;
2604000;"Powiat kielecki";211751;22756;188995;
2604000;"Powiat kielecki - URBAN-RURAL GMINAS";116237;22756;93481;
2604012;"Bieliny (2)";9922;0;9922;
2604023;"Bodzentyn (3)";10915;2079;8836;
2604024;"Bodzentyn - urban area (4)";2079;2079;0;
2604025;"Bodzentyn - rural area (5)";8836;0;8836;
2604033;"Chęciny (3)";14749;4304;10445;
2604034;"Chęciny - urban area (4)";4304;4304;0;
2604035;"Chęciny - rural area (5)";10445;0;10445;
2604043;"Chmielnik (3)";10702;3408;7294;
2604044;"Chmielnik - urban area (4)";3408;3408;0;
2604045;"Chmielnik - rural area (5)";7294;0;7294;
2604053;"Daleszyce (3)";16273;2737;13536;
2604054;"Daleszyce - urban area (4)";2737;2737;0;
2604055;"Daleszyce - rural area (5)";13536;0;13536;
2604062;"Górno (2)";15210;0;15210;
2604073;"Łagów (3)";6544;1511;5033;
2604074;"Łagów - urban area (4)";1511;1511;0;
2604075;"Łagów - rural area (5)";5033;0;5033;
2604083;"Łopuszno (3)";8691;1437;7254;
2604084;"Łopuszno - urban area (4)";1437;1437;0;
2604085;"Łopuszno - rural area (5)";7254;0;7254;
2604092;"Masłów (2)";11991;0;11991;
2604102;"Miedziana Góra (2)";12627;0;12627;
2604112;"Mniów (2)";9031;0;9031;
2604123;"Morawica (3)";18043;1759;16284;
2604124;"Morawica - urban area (4)";1759;1759;0;
2604125;"Morawica - rural area (5)";16284;0;16284;
2604133;"Nowa Słupia (3)";8764;1290;7474;
2604134;"Nowa Słupia - urban area (4)";1290;1290;0;
2604135;"Nowa Słupia - rural area (5)";7474;0;7474;
2604143;"Piekoszów (3)";16881;2976;13905;
2604144;"Piekoszów - urban area (4)";2976;2976;0;
2604145;"Piekoszów - rural area (5)";13905;0;13905;
2604153;"Pierzchnica (3)";4675;1255;3420;
2604154;"Pierzchnica - urban area (4)";1255;1255;0;
2604155;"Pierzchnica - rural area (5)";3420;0;3420;
2604162;"Raków (2)";5233;0;5233;
2604172;"Nowiny (2)";8149;0;8149;
2604182;"Strawczyn (2)";11230;0;11230;
2604192;"Zagnańsk (2)";12121;0;12121;
2605000;"Powiat konecki";73236;26408;46828;
2605000;"Powiat konecki - URBAN-RURAL GMINAS";59900;26408;33492;
2605012;"Fałków (2)";3906;0;3906;
2605023;"Gowarczów (3)";4381;1320;3061;
2605024;"Gowarczów - urban area (4)";1320;1320;0;
2605025;"Gowarczów - rural area (5)";3061;0;3061;
2605033;"Końskie (3)";32265;17244;15021;
2605034;"Końskie - urban area (4)";17244;17244;0;
2605035;"Końskie - rural area (5)";15021;0;15021;
2605043;"Radoszyce (3)";8076;2792;5284;
2605044;"Radoszyce - urban area (4)";2792;2792;0;
2605045;"Radoszyce - rural area (5)";5284;0;5284;
2605052;"Ruda Maleniecka (2)";2829;0;2829;
2605062;"Słupia Konecka (2)";2932;0;2932;
2605072;"Smyków (2)";3669;0;3669;
2605083;"Stąporków (3)";15178;5052;10126;
2605084;"Stąporków - urban area (4)";5052;5052;0;
2605085;"Stąporków - rural area (5)";10126;0;10126;
2606000;"Powiat opatowski";48144;11253;36891;
2606000;"Powiat opatowski - URBAN-RURAL GMINAS";26790;11253;15537;
2606012;"Baćkowice (2)";4520;0;4520;
2606023;"Iwaniska (3)";6082;1206;4876;
2606024;"Iwaniska - urban area (4)";1206;1206;0;
2606025;"Iwaniska - rural area (5)";4876;0;4876;
2606032;"Lipnik (2)";4786;0;4786;
2606043;"Opatów (3)";10659;5875;4784;
2606044;"Opatów - urban area (4)";5875;5875;0;
2606045;"Opatów - rural area (5)";4784;0;4784;
2606053;"Ożarów (3)";10049;4172;5877;
2606054;"Ożarów - urban area (4)";4172;4172;0;
2606055;"Ożarów - rural area (5)";5877;0;5877;
2606062;"Sadowie (2)";3744;0;3744;
2606072;"Tarłów (2)";4561;0;4561;
2606082;"Wojciechowice (2)";3743;0;3743;
2607000;"Powiat ostrowiecki";99429;67108;32321;
2607000;"Powiat ostrowiecki - URBAN GMINAS";61637;61637;0;
2607000;"Powiat ostrowiecki - URBAN-RURAL GMINAS";15806;5471;10335;
2607011;"Ostrowiec Świętokrzyski (1)";61637;61637;0;
2607022;"Bałtów (2)";3091;0;3091;
2607032;"Bodzechów (2)";12599;0;12599;
2607043;"Ćmielów (3)";6705;2770;3935;
2607044;"Ćmielów - urban area (4)";2770;2770;0;
2607045;"Ćmielów - rural area (5)";3935;0;3935;
2607053;"Kunów (3)";9101;2701;6400;
2607054;"Kunów - urban area (4)";2701;2701;0;
2607055;"Kunów - rural area (5)";6400;0;6400;
2607062;"Waśniów (2)";6296;0;6296;
2608000;"Powiat pińczowski";36509;10458;26051;
2608000;"Powiat pińczowski - URBAN-RURAL GMINAS";23635;10458;13177;
2608013;"Działoszyce (3)";4536;826;3710;
2608014;"Działoszyce - urban area (4)";826;826;0;
2608015;"Działoszyce - rural area (5)";3710;0;3710;
2608022;"Kije (2)";4281;0;4281;
2608032;"Michałów (2)";4379;0;4379;
2608043;"Pińczów (3)";19099;9632;9467;
2608044;"Pińczów - urban area (4)";9632;9632;0;
2608045;"Pińczów - rural area (5)";9467;0;9467;
2608052;"Złota (2)";4214;0;4214;
2609000;"Powiat sandomierski";71362;26802;44560;
2609000;"Powiat sandomierski - URBAN GMINAS";21114;21114;0;
2609000;"Powiat sandomierski - URBAN-RURAL GMINAS";17586;5688;11898;
2609011;"Sandomierz (1)";21114;21114;0;
2609022;"Dwikozy (2)";8108;0;8108;
2609033;"Klimontów (3)";7423;1747;5676;
2609034;"Klimontów - urban area (4)";1747;1747;0;
2609035;"Klimontów - rural area (5)";5676;0;5676;
2609043;"Koprzywnica (3)";6189;2357;3832;
2609044;"Koprzywnica - urban area (4)";2357;2357;0;
2609045;"Koprzywnica - rural area (5)";3832;0;3832;
2609052;"Łoniów (2)";7086;0;7086;
2609062;"Obrazów (2)";6050;0;6050;
2609072;"Samborzec (2)";8016;0;8016;
2609082;"Wilczyce (2)";3402;0;3402;
2609093;"Zawichost (3)";3974;1584;2390;
2609094;"Zawichost - urban area (4)";1584;1584;0;
2609095;"Zawichost - rural area (5)";2390;0;2390;
2610000;"Powiat skarżyski";67647;48328;19319;
2610000;"Powiat skarżyski - URBAN GMINAS";40928;40928;0;
2610000;"Powiat skarżyski - URBAN-RURAL GMINAS";9070;7400;1670;
2610011;"Skarżysko-Kamienna (1)";40928;40928;0;
2610022;"Bliżyn (2)";7414;0;7414;
2610032;"Łączna (2)";4769;0;4769;
2610042;"Skarżysko Kościelne (2)";5466;0;5466;
2610053;"Suchedniów (3)";9070;7400;1670;
2610054;"Suchedniów - urban area (4)";7400;7400;0;
2610055;"Suchedniów - rural area (5)";1670;0;1670;
2611000;"Powiat starachowicki";83109;46478;36631;
2611000;"Powiat starachowicki - URBAN GMINAS";44038;44038;0;
2611000;"Powiat starachowicki - URBAN-RURAL GMINAS";6293;2440;3853;
2611011;"Starachowice (1)";44038;44038;0;
2611022;"Brody (2)";10065;0;10065;
2611032;"Mirzec (2)";7905;0;7905;
2611042;"Pawłów (2)";14808;0;14808;
2611053;"Wąchock (3)";6293;2440;3853;
2611054;"Wąchock - urban area (4)";2440;2440;0;
2611055;"Wąchock - rural area (5)";3853;0;3853;
2612000;"Powiat staszowski";68106;26570;41536;
2612000;"Powiat staszowski - URBAN-RURAL GMINAS";57982;26570;31412;
2612013;"Bogoria (3)";7397;1088;6309;
2612014;"Bogoria - urban area (4)";1088;1088;0;
2612015;"Bogoria - rural area (5)";6309;0;6309;
2612022;"Łubnice (2)";3910;0;3910;
2612033;"Oleśnica (3)";3755;1712;2043;
2612034;"Oleśnica - urban area (4)";1712;1712;0;
2612035;"Oleśnica - rural area (5)";2043;0;2043;
2612043;"Osiek (3)";7313;1962;5351;
2612044;"Osiek - urban area (4)";1962;1962;0;
2612045;"Osiek - rural area (5)";5351;0;5351;
2612053;"Połaniec (3)";10937;7387;3550;
2612054;"Połaniec - urban area (4)";7387;7387;0;
2612055;"Połaniec - rural area (5)";3550;0;3550;
2612062;"Rytwiany (2)";6214;0;6214;
2612073;"Staszów (3)";24246;13463;10783;
2612074;"Staszów - urban area (4)";13463;13463;0;
2612075;"Staszów - rural area (5)";10783;0;10783;
2612083;"Szydłów (3)";4334;958;3376;
2612084;"Szydłów - urban area (4)";958;958;0;
2612085;"Szydłów - rural area (5)";3376;0;3376;
2613000;"Powiat włoszczowski";42740;9467;33273;
2613000;"Powiat włoszczowski - URBAN-RURAL GMINAS";18497;9467;9030;
2613012;"Kluczewsko (2)";4898;0;4898;
2613022;"Krasocin (2)";10050;0;10050;
2613032;"Moskorzew (2)";2516;0;2516;
2613042;"Radków (2)";2266;0;2266;
2613052;"Secemin (2)";4513;0;4513;
2613063;"Włoszczowa (3)";18497;9467;9030;
2613064;"Włoszczowa - urban area (4)";9467;9467;0;
2613065;"Włoszczowa - rural area (5)";9030;0;9030;
2661000;"City with powiat status Kielce";181211;181211;0;
2661000;"City with powiat status Kielce - URBAN GMINAS";181211;181211;0;
2661011;"Kielce (1)";181211;181211;0;
2801000;"Powiat bartoszycki";52308;28801;23507;
2801000;"Powiat bartoszycki - URBAN GMINAS";24787;24787;0;
2801000;"Powiat bartoszycki - URBAN-RURAL GMINAS";11259;4014;7245;
2801011;"Bartoszyce (1)";21180;21180;0;
2801021;"Górowo Iławeckie (1)";3607;3607;0;
2801032;"Bartoszyce (2)";10174;0;10174;
2801043;"Bisztynek (3)";5601;2127;3474;
2801044;"Bisztynek - urban area (4)";2127;2127;0;
2801045;"Bisztynek - rural area (5)";3474;0;3474;
2801052;"Górowo Iławeckie (2)";6088;0;6088;
2801063;"Sępopol (3)";5658;1887;3771;
2801064;"Sępopol - urban area (4)";1887;1887;0;
2801065;"Sępopol - rural area (5)";3771;0;3771;
2802000;"Powiat braniewski";37028;20361;16667;
2802000;"Powiat braniewski - URBAN GMINAS";15968;15968;0;
2802000;"Powiat braniewski - URBAN-RURAL GMINAS";8505;4393;4112;
2802011;"Braniewo (1)";15968;15968;0;
2802022;"Braniewo (2)";5332;0;5332;
2802033;"Frombork (3)";3040;1993;1047;
2802034;"Frombork - urban area (4)";1993;1993;0;
2802035;"Frombork - rural area (5)";1047;0;1047;
2802042;"Lelkowo (2)";2356;0;2356;
2802053;"Pieniężno (3)";5465;2400;3065;
2802054;"Pieniężno - urban area (4)";2400;2400;0;
2802055;"Pieniężno - rural area (5)";3065;0;3065;
2802062;"Płoskinia (2)";2331;0;2331;
2802072;"Wilczęta (2)";2536;0;2536;
2803000;"Powiat działdowski";61171;27152;34019;
2803000;"Powiat działdowski - URBAN GMINAS";20000;20000;0;
2803000;"Powiat działdowski - URBAN-RURAL GMINAS";13111;7152;5959;
2803011;"Działdowo (1)";20000;20000;0;
2803022;"Działdowo (2)";9607;0;9607;
2803032;"Iłowo-Osada (2)";6690;0;6690;
2803043;"Lidzbark (3)";13111;7152;5959;
2803044;"Lidzbark - urban area (4)";7152;7152;0;
2803045;"Lidzbark - rural area (5)";5959;0;5959;
2803052;"Płośnica (2)";5070;0;5070;
2803062;"Rybno (2)";6693;0;6693;
2804000;"Powiat elbląski";53899;15697;38202;
2804000;"Powiat elbląski - URBAN-RURAL GMINAS";28226;15697;12529;
2804012;"Elbląg (2)";7651;0;7651;
2804022;"Godkowo (2)";2698;0;2698;
2804032;"Gronowo Elbląskie (2)";4752;0;4752;
2804042;"Markusy (2)";3860;0;3860;
2804052;"Milejewo (2)";3262;0;3262;
2804063;"Młynary (3)";4124;1664;2460;
2804064;"Młynary - urban area (4)";1664;1664;0;
2804065;"Młynary - rural area (5)";2460;0;2460;
2804073;"Pasłęk (3)";18150;11658;6492;
2804074;"Pasłęk - urban area (4)";11658;11658;0;
2804075;"Pasłęk - rural area (5)";6492;0;6492;
2804082;"Rychliki (2)";3450;0;3450;
2804093;"Tolkmicko (3)";5952;2375;3577;
2804094;"Tolkmicko - urban area (4)";2375;2375;0;
2804095;"Tolkmicko - rural area (5)";3577;0;3577;
2805000;"Powiat ełcki";88189;59463;28726;
2805000;"Powiat ełcki - URBAN GMINAS";59463;59463;0;
2805011;"Ełk (1)";59463;59463;0;
2805022;"Ełk (2)";12649;0;12649;
2805032;"Kalinowo (2)";6110;0;6110;
2805042;"Prostki (2)";6652;0;6652;
2805052;"Stare Juchy (2)";3315;0;3315;
2806000;"Powiat giżycki";53484;29770;23714;
2806000;"Powiat giżycki - URBAN GMINAS";27107;27107;0;
2806000;"Powiat giżycki - URBAN-RURAL GMINAS";5329;2663;2666;
2806011;"Giżycko (1)";27107;27107;0;
2806042;"Giżycko (2)";8972;0;8972;
2806052;"Kruklanki (2)";2905;0;2905;
2806062;"Miłki (2)";3395;0;3395;
2806083;"Ryn (3)";5329;2663;2666;
2806084;"Ryn - urban area (4)";2663;2663;0;
2806085;"Ryn - rural area (5)";2666;0;2666;
2806102;"Wydminy (2)";5776;0;5776;
2807000;"Powiat iławski";89670;51989;37681;
2807000;"Powiat iławski - URBAN GMINAS";42769;42769;0;
2807000;"Powiat iławski - URBAN-RURAL GMINAS";23319;9220;14099;
2807011;"Iława (1)";32106;32106;0;
2807021;"Lubawa (1)";10663;10663;0;
2807032;"Iława (2)";13239;0;13239;
2807043;"Kisielice (3)";5510;1992;3518;
2807044;"Kisielice - urban area (4)";1992;1992;0;
2807045;"Kisielice - rural area (5)";3518;0;3518;
2807052;"Lubawa (2)";10343;0;10343;
2807063;"Susz (3)";11713;5217;6496;
2807064;"Susz - urban area (4)";5217;5217;0;
2807065;"Susz - rural area (5)";6496;0;6496;
2807073;"Zalewo (3)";6096;2011;4085;
2807074;"Zalewo - urban area (4)";2011;2011;0;
2807075;"Zalewo - rural area (5)";4085;0;4085;
2808000;"Powiat kętrzyński";56647;32847;23800;
2808000;"Powiat kętrzyński - URBAN GMINAS";24930;24930;0;
2808000;"Powiat kętrzyński - URBAN-RURAL GMINAS";15216;7917;7299;
2808011;"Kętrzyn (1)";24930;24930;0;
2808022;"Barciany (2)";5572;0;5572;
2808032;"Kętrzyn (2)";7579;0;7579;
2808043;"Korsze (3)";8632;3911;4721;
2808044;"Korsze - urban area (4)";3911;3911;0;
2808045;"Korsze - rural area (5)";4721;0;4721;
2808053;"Reszel (3)";6584;4006;2578;
2808054;"Reszel - urban area (4)";4006;4006;0;
2808055;"Reszel - rural area (5)";2578;0;2578;
2808062;"Srokowo (2)";3350;0;3350;
2809000;"Powiat lidzbarski";37962;22308;15654;
2809000;"Powiat lidzbarski - URBAN GMINAS";14366;14366;0;
2809000;"Powiat lidzbarski - URBAN-RURAL GMINAS";10842;7942;2900;
2809011;"Lidzbark Warmiński (1)";14366;14366;0;
2809022;"Kiwity (2)";3042;0;3042;
2809032;"Lidzbark Warmiński (2)";6430;0;6430;
2809042;"Lubomino (2)";3282;0;3282;
2809053;"Orneta (3)";10842;7942;2900;
2809054;"Orneta - urban area (4)";7942;7942;0;
2809055;"Orneta - rural area (5)";2900;0;2900;
2810000;"Powiat mrągowski";47266;23737;23529;
2810000;"Powiat mrągowski - URBAN GMINAS";20399;20399;0;
2810000;"Powiat mrągowski - URBAN-RURAL GMINAS";7293;3338;3955;
2810011;"Mrągowo (1)";20399;20399;0;
2810023;"Mikołajki (3)";7293;3338;3955;
2810024;"Mikołajki - urban area (4)";3338;3338;0;
2810025;"Mikołajki - rural area (5)";3955;0;3955;
2810032;"Mrągowo (2)";8078;0;8078;
2810042;"Piecki (2)";7120;0;7120;
2810052;"Sorkwity (2)";4376;0;4376;
2811000;"Powiat nidzicki";30323;12532;17791;
2811000;"Powiat nidzicki - URBAN-RURAL GMINAS";19633;12532;7101;
2811012;"Janowiec Kościelny (2)";2908;0;2908;
2811022;"Janowo (2)";2497;0;2497;
2811032;"Kozłowo (2)";5285;0;5285;
2811043;"Nidzica (3)";19633;12532;7101;
2811044;"Nidzica - urban area (4)";12532;12532;0;
2811045;"Nidzica - rural area (5)";7101;0;7101;
2812000;"Powiat nowomiejski";41829;10058;31771;
2812000;"Powiat nowomiejski - URBAN GMINAS";10058;10058;0;
2812011;"Nowe Miasto Lubawskie (1)";10058;10058;0;
2812022;"Biskupiec (2)";8533;0;8533;
2812032;"Grodziczno (2)";5832;0;5832;
2812042;"Kurzętnik (2)";8968;0;8968;
2812052;"Nowe Miasto Lubawskie (2)";8438;0;8438;
2813000;"Powiat olecki";31863;15617;16246;
2813000;"Powiat olecki - URBAN-RURAL GMINAS";20871;15617;5254;
2813032;"Kowale Oleckie (2)";4525;0;4525;
2813043;"Olecko (3)";20871;15617;5254;
2813044;"Olecko - urban area (4)";15617;15617;0;
2813045;"Olecko - rural area (5)";5254;0;5254;
2813052;"Świętajno (2)";3293;0;3293;
2813062;"Wieliczki (2)";3174;0;3174;
2814000;"Powiat olsztyński";130299;36564;93735;
2814000;"Powiat olsztyński - URBAN-RURAL GMINAS";70930;36564;34366;
2814013;"Barczewo (3)";18327;7356;10971;
2814014;"Barczewo - urban area (4)";7356;7356;0;
2814015;"Barczewo - rural area (5)";10971;0;10971;
2814023;"Biskupiec (3)";17665;9891;7774;
2814024;"Biskupiec - urban area (4)";9891;9891;0;
2814025;"Biskupiec - rural area (5)";7774;0;7774;
2814033;"Dobre Miasto (3)";14971;9256;5715;
2814034;"Dobre Miasto - urban area (4)";9256;9256;0;
2814035;"Dobre Miasto - rural area (5)";5715;0;5715;
2814042;"Dywity (2)";13844;0;13844;
2814052;"Gietrzwałd (2)";6982;0;6982;
2814063;"Jeziorany (3)";6887;2914;3973;
2814064;"Jeziorany - urban area (4)";2914;2914;0;
2814065;"Jeziorany - rural area (5)";3973;0;3973;
2814072;"Jonkowo (2)";7904;0;7904;
2814082;"Kolno (2)";2732;0;2732;
2814093;"Olsztynek (3)";13080;7147;5933;
2814094;"Olsztynek - urban area (4)";7147;7147;0;
2814095;"Olsztynek - rural area (5)";5933;0;5933;
2814102;"Purda (2)";9000;0;9000;
2814112;"Stawiguda (2)";15207;0;15207;
2814122;"Świątki (2)";3700;0;3700;
2815000;"Powiat ostródzki";98667;48691;49976;
2815000;"Powiat ostródzki - URBAN GMINAS";31243;31243;0;
2815000;"Powiat ostródzki - URBAN-RURAL GMINAS";32540;17448;15092;
2815011;"Ostróda (1)";31243;31243;0;
2815022;"Dąbrówno (2)";3856;0;3856;
2815032;"Grunwald (2)";5029;0;5029;
2815042;"Łukta (2)";4358;0;4358;
2815052;"Małdyty (2)";5720;0;5720;
2815063;"Miłakowo (3)";4903;2385;2518;
2815064;"Miłakowo - urban area (4)";2385;2385;0;
2815065;"Miłakowo - rural area (5)";2518;0;2518;
2815073;"Miłomłyn (3)";4742;2409;2333;
2815074;"Miłomłyn - urban area (4)";2409;2409;0;
2815075;"Miłomłyn - rural area (5)";2333;0;2333;
2815083;"Morąg (3)";22895;12654;10241;
2815084;"Morąg - urban area (4)";12654;12654;0;
2815085;"Morąg - rural area (5)";10241;0;10241;
2815092;"Ostróda (2)";15921;0;15921;
2816000;"Powiat piski";51796;30471;21325;
2816000;"Powiat piski - URBAN-RURAL GMINAS";51796;30471;21325;
2816013;"Biała Piska (3)";10336;3658;6678;
2816014;"Biała Piska - urban area (4)";3658;3658;0;
2816015;"Biała Piska - rural area (5)";6678;0;6678;
2816023;"Orzysz (3)";8328;5235;3093;
2816024;"Orzysz - urban area (4)";5235;5235;0;
2816025;"Orzysz - rural area (5)";3093;0;3093;
2816033;"Pisz (3)";25854;17531;8323;
2816034;"Pisz - urban area (4)";17531;17531;0;
2816035;"Pisz - rural area (5)";8323;0;8323;
2816043;"Ruciane-Nida (3)";7278;4047;3231;
2816044;"Ruciane-Nida - urban area (4)";4047;4047;0;
2816045;"Ruciane-Nida - rural area (5)";3231;0;3231;
2817000;"Powiat szczycieński";66390;27117;39273;
2817000;"Powiat szczycieński - URBAN GMINAS";21749;21749;0;
2817000;"Powiat szczycieński - URBAN-RURAL GMINAS";11277;5368;5909;
2817011;"Szczytno (1)";21749;21749;0;
2817022;"Dźwierzuty (2)";5812;0;5812;
2817032;"Jedwabno (2)";3439;0;3439;
2817043;"Pasym (3)";5052;2390;2662;
2817044;"Pasym - urban area (4)";2390;2390;0;
2817045;"Pasym - rural area (5)";2662;0;2662;
2817052;"Rozogi (2)";5161;0;5161;
2817062;"Szczytno (2)";13646;0;13646;
2817072;"Świętajno (2)";5306;0;5306;
2817083;"Wielbark (3)";6225;2978;3247;
2817084;"Wielbark - urban area (4)";2978;2978;0;
2817085;"Wielbark - rural area (5)";3247;0;3247;
2818000;"Powiat gołdapski";24738;13148;11590;
2818000;"Powiat gołdapski - URBAN-RURAL GMINAS";18961;13148;5813;
2818012;"Banie Mazurskie (2)";3170;0;3170;
2818022;"Dubeninki (2)";2607;0;2607;
2818033;"Gołdap (3)";18961;13148;5813;
2818034;"Gołdap - urban area (4)";13148;13148;0;
2818035;"Gołdap - rural area (5)";5813;0;5813;
2819000;"Powiat węgorzewski";20703;10488;10215;
2819000;"Powiat węgorzewski - URBAN-RURAL GMINAS";15213;10488;4725;
2819012;"Budry (2)";2524;0;2524;
2819022;"Pozezdrze (2)";2966;0;2966;
2819033;"Węgorzewo (3)";15213;10488;4725;
2819034;"Węgorzewo - urban area (4)";10488;10488;0;
2819035;"Węgorzewo - rural area (5)";4725;0;4725;
2861000;"City with powiat status Elbląg";112445;112445;0;
2861000;"City with powiat status Elbląg - URBAN GMINAS";112445;112445;0;
2861011;"Elbląg (1)";112445;112445;0;
2862000;"City with powiat status Olsztyn";166697;166697;0;
2862000;"City with powiat status Olsztyn - URBAN GMINAS";166697;166697;0;
2862011;"Olsztyn (1)";166697;166697;0;
3001000;"Powiat chodzieski";45051;28681;16370;
3001000;"Powiat chodzieski - URBAN GMINAS";17173;17173;0;
3001000;"Powiat chodzieski - URBAN-RURAL GMINAS";21714;11508;10206;
3001011;"Chodzież (1)";17173;17173;0;
3001023;"Budzyń (3)";8289;4668;3621;
3001024;"Budzyń - urban area (4)";4668;4668;0;
3001025;"Budzyń - rural area (5)";3621;0;3621;
3001032;"Chodzież (2)";6164;0;6164;
3001043;"Margonin (3)";6291;2952;3339;
3001044;"Margonin - urban area (4)";2952;2952;0;
3001045;"Margonin - rural area (5)";3339;0;3339;
3001053;"Szamocin (3)";7134;3888;3246;
3001054;"Szamocin - urban area (4)";3888;3888;0;
3001055;"Szamocin - rural area (5)";3246;0;3246;
3002000;"Powiat czarnkowsko-trzcianecki";83182;37712;45470;
3002000;"Powiat czarnkowsko-trzcianecki - URBAN GMINAS";9838;9838;0;
3002000;"Powiat czarnkowsko-trzcianecki - URBAN-RURAL GMINAS";43159;27874;15285;
3002011;"Czarnków (1)";9838;9838;0;
3002022;"Czarnków (2)";11167;0;11167;
3002032;"Drawsko (2)";5537;0;5537;
3002043;"Krzyż Wielkopolski (3)";8194;5856;2338;
3002044;"Krzyż Wielkopolski - urban area (4)";5856;5856;0;
3002045;"Krzyż Wielkopolski - rural area (5)";2338;0;2338;
3002052;"Lubasz (2)";7523;0;7523;
3002062;"Połajewo (2)";5958;0;5958;
3002073;"Trzcianka (3)";23361;16389;6972;
3002074;"Trzcianka - urban area (4)";16389;16389;0;
3002075;"Trzcianka - rural area (5)";6972;0;6972;
3002083;"Wieleń (3)";11604;5629;5975;
3002084;"Wieleń - urban area (4)";5629;5629;0;
3002085;"Wieleń - rural area (5)";5975;0;5975;
3003000;"Powiat gnieźnieński";140979;82839;58140;
3003000;"Powiat gnieźnieński - URBAN GMINAS";63143;63143;0;
3003000;"Powiat gnieźnieński - URBAN-RURAL GMINAS";40984;19696;21288;
3003011;"Gniezno (1)";63143;63143;0;
3003023;"Czerniejewo (3)";7237;2554;4683;
3003024;"Czerniejewo - urban area (4)";2554;2554;0;
3003025;"Czerniejewo - rural area (5)";4683;0;4683;
3003032;"Gniezno (2)";14786;0;14786;
3003042;"Kiszkowo (2)";5123;0;5123;
3003053;"Kłecko (3)";7084;2496;4588;
3003054;"Kłecko - urban area (4)";2496;2496;0;
3003055;"Kłecko - rural area (5)";4588;0;4588;
3003062;"Łubowo (2)";7381;0;7381;
3003072;"Mieleszyn (2)";3631;0;3631;
3003082;"Niechanowo (2)";5931;0;5931;
3003093;"Trzemeszno (3)";13666;7247;6419;
3003094;"Trzemeszno - urban area (4)";7247;7247;0;
3003095;"Trzemeszno - rural area (5)";6419;0;6419;
3003103;"Witkowo (3)";12997;7399;5598;
3003104;"Witkowo - urban area (4)";7399;7399;0;
3003105;"Witkowo - rural area (5)";5598;0;5598;
3004000;"Powiat gostyński";73223;31642;41581;
3004000;"Powiat gostyński - URBAN-RURAL GMINAS";59336;31642;27694;
3004013;"Borek Wielkopolski (3)";6993;2428;4565;
3004014;"Borek Wielkopolski - urban area (4)";2428;2428;0;
3004015;"Borek Wielkopolski - rural area (5)";4565;0;4565;
3004023;"Gostyń (3)";27702;19748;7954;
3004024;"Gostyń - urban area (4)";19748;19748;0;
3004025;"Gostyń - rural area (5)";7954;0;7954;
3004033;"Krobia (3)";12554;4529;8025;
3004034;"Krobia - urban area (4)";4529;4529;0;
3004035;"Krobia - rural area (5)";8025;0;8025;
3004042;"Pępowo (2)";5704;0;5704;
3004052;"Piaski (2)";8183;0;8183;
3004063;"Pogorzela (3)";4659;2027;2632;
3004064;"Pogorzela - urban area (4)";2027;2027;0;
3004065;"Pogorzela - rural area (5)";2632;0;2632;
3004073;"Poniec (3)";7428;2910;4518;
3004074;"Poniec - urban area (4)";2910;2910;0;
3004075;"Poniec - rural area (5)";4518;0;4518;
3005000;"Powiat grodziski";51489;20329;31160;
3005000;"Powiat grodziski - URBAN-RURAL GMINAS";40243;20329;19914;
3005012;"Granowo (2)";5049;0;5049;
3005023;"Grodzisk Wielkopolski (3)";20355;15104;5251;
3005024;"Grodzisk Wielkopolski - urban area (4)";15104;15104;0;
3005025;"Grodzisk Wielkopolski - rural area (5)";5251;0;5251;
3005032;"Kamieniec (2)";6197;0;6197;
3005043;"Rakoniewice (3)";13241;3582;9659;
3005044;"Rakoniewice - urban area (4)";3582;3582;0;
3005045;"Rakoniewice - rural area (5)";9659;0;9659;
3005053;"Wielichowo (3)";6647;1643;5004;
3005054;"Wielichowo - urban area (4)";1643;1643;0;
3005055;"Wielichowo - rural area (5)";5004;0;5004;
3006000;"Powiat jarociński";69624;29696;39928;
3006000;"Powiat jarociński - URBAN-RURAL GMINAS";62699;29696;33003;
3006013;"Jaraczewo (3)";7591;1377;6214;
3006014;"Jaraczewo - urban area (4)";1377;1377;0;
3006015;"Jaraczewo - rural area (5)";6214;0;6214;
3006023;"Jarocin (3)";45399;26253;19146;
3006024;"Jarocin - urban area (4)";26253;26253;0;
3006025;"Jarocin - rural area (5)";19146;0;19146;
3006032;"Kotlin (2)";6925;0;6925;
3006043;"Żerków (3)";9709;2066;7643;
3006044;"Żerków - urban area (4)";2066;2066;0;
3006045;"Żerków - rural area (5)";7643;0;7643;
3007000;"Powiat kaliski";82052;6663;75389;
3007000;"Powiat kaliski - URBAN-RURAL GMINAS";24519;6663;17856;
3007012;"Blizanów (2)";10070;0;10070;
3007022;"Brzeziny (2)";5734;0;5734;
3007032;"Ceków-Kolonia (2)";4720;0;4720;
3007042;"Godziesze Wielkie (2)";10189;0;10189;
3007053;"Koźminek (3)";7293;1825;5468;
3007054;"Koźminek - urban area (4)";1825;1825;0;
3007055;"Koźminek - rural area (5)";5468;0;5468;
3007062;"Lisków (2)";5100;0;5100;
3007072;"Mycielin (2)";4619;0;4619;
3007083;"Opatówek (3)";10626;3486;7140;
3007084;"Opatówek - urban area (4)";3486;3486;0;
3007085;"Opatówek - rural area (5)";7140;0;7140;
3007093;"Stawiszyn (3)";6600;1352;5248;
3007094;"Stawiszyn - urban area (4)";1352;1352;0;
3007095;"Stawiszyn - rural area (5)";5248;0;5248;
3007102;"Szczytniki (2)";7521;0;7521;
3007112;"Żelazków (2)";9580;0;9580;
3008000;"Powiat kępiński";55792;14763;41029;
3008000;"Powiat kępiński - URBAN-RURAL GMINAS";27605;14763;12842;
3008012;"Baranów (2)";8283;0;8283;
3008022;"Bralin (2)";6108;0;6108;
3008033;"Kępno (3)";24033;13429;10604;
3008034;"Kępno - urban area (4)";13429;13429;0;
3008035;"Kępno - rural area (5)";10604;0;10604;
3008042;"Łęka Opatowska (2)";5108;0;5108;
3008052;"Perzów (2)";3770;0;3770;
3008063;"Rychtal (3)";3572;1334;2238;
3008064;"Rychtal - urban area (4)";1334;1334;0;
3008065;"Rychtal - rural area (5)";2238;0;2238;
3008072;"Trzcinica (2)";4918;0;4918;
3009000;"Powiat kolski";81197;28315;52882;
3009000;"Powiat kolski - URBAN GMINAS";19284;19284;0;
3009000;"Powiat kolski - URBAN-RURAL GMINAS";21329;9031;12298;
3009011;"Koło (1)";19284;19284;0;
3009022;"Babiak (2)";7279;0;7279;
3009032;"Chodów (2)";2790;0;2790;
3009043;"Dąbie (3)";5687;1694;3993;
3009044;"Dąbie - urban area (4)";1694;1694;0;
3009045;"Dąbie - rural area (5)";3993;0;3993;
3009052;"Grzegorzew (2)";5339;0;5339;
3009063;"Kłodawa (3)";11752;5824;5928;
3009064;"Kłodawa - urban area (4)";5824;5824;0;
3009065;"Kłodawa - rural area (5)";5928;0;5928;
3009072;"Koło (2)";7986;0;7986;
3009082;"Kościelec (2)";6779;0;6779;
3009092;"Olszówka (2)";4110;0;4110;
3009102;"Osiek Mały (2)";6301;0;6301;
3009113;"Przedecz (3)";3890;1513;2377;
3009114;"Przedecz - urban area (4)";1513;1513;0;
3009115;"Przedecz - rural area (5)";2377;0;2377;
3010000;"Powiat koniński";128650;16891;111759;
3010000;"Powiat koniński - URBAN-RURAL GMINAS";53847;16891;36956;
3010013;"Golina (3)";12366;4259;8107;
3010014;"Golina - urban area (4)";4259;4259;0;
3010015;"Golina - rural area (5)";8107;0;8107;
3010022;"Grodziec (2)";4931;0;4931;
3010032;"Kazimierz Biskupi (2)";11525;0;11525;
3010043;"Kleczew (3)";9569;3858;5711;
3010044;"Kleczew - urban area (4)";3858;3858;0;
3010045;"Kleczew - rural area (5)";5711;0;5711;
3010052;"Kramsk (2)";11615;0;11615;
3010062;"Krzymów (2)";8302;0;8302;
3010073;"Rychwał (3)";7977;2375;5602;
3010074;"Rychwał - urban area (4)";2375;2375;0;
3010075;"Rychwał - rural area (5)";5602;0;5602;
3010082;"Rzgów (2)";7106;0;7106;
3010092;"Skulsk (2)";5698;0;5698;
3010103;"Sompolno (3)";10009;3301;6708;
3010104;"Sompolno - urban area (4)";3301;3301;0;
3010105;"Sompolno - rural area (5)";6708;0;6708;
3010112;"Stare Miasto (2)";12991;0;12991;
3010123;"Ślesin (3)";13926;3098;10828;
3010124;"Ślesin - urban area (4)";3098;3098;0;
3010125;"Ślesin - rural area (5)";10828;0;10828;
3010132;"Wierzbinek (2)";6888;0;6888;
3010142;"Wilczyn (2)";5747;0;5747;
3011000;"Powiat kościański";77031;35618;41413;
3011000;"Powiat kościański - URBAN GMINAS";23267;23267;0;
3011000;"Powiat kościański - URBAN-RURAL GMINAS";37890;12351;25539;
3011011;"Kościan (1)";23267;23267;0;
3011023;"Czempiń (3)";11416;5070;6346;
3011024;"Czempiń - urban area (4)";5070;5070;0;
3011025;"Czempiń - rural area (5)";6346;0;6346;
3011032;"Kościan (2)";15874;0;15874;
3011043;"Krzywiń (3)";9452;1653;7799;
3011044;"Krzywiń - urban area (4)";1653;1653;0;
3011045;"Krzywiń - rural area (5)";7799;0;7799;
3011053;"Śmigiel (3)";17022;5628;11394;
3011054;"Śmigiel - urban area (4)";5628;5628;0;
3011055;"Śmigiel - rural area (5)";11394;0;11394;
3012000;"Powiat krotoszyński";74709;44366;30343;
3012000;"Powiat krotoszyński - URBAN GMINAS";2729;2729;0;
3012000;"Powiat krotoszyński - URBAN-RURAL GMINAS";67052;41637;25415;
3012011;"Sulmierzyce (1)";2729;2729;0;
3012023;"Kobylin (3)";7663;3196;4467;
3012024;"Kobylin - urban area (4)";3196;3196;0;
3012025;"Kobylin - rural area (5)";4467;0;4467;
3012033;"Koźmin Wielkopolski (3)";12515;6091;6424;
3012034;"Koźmin Wielkopolski - urban area (4)";6091;6091;0;
3012035;"Koźmin Wielkopolski - rural area (5)";6424;0;6424;
3012043;"Krotoszyn (3)";39277;28060;11217;
3012044;"Krotoszyn - urban area (4)";28060;28060;0;
3012045;"Krotoszyn - rural area (5)";11217;0;11217;
3012052;"Rozdrażew (2)";4928;0;4928;
3012063;"Zduny (3)";7597;4290;3307;
3012064;"Zduny - urban area (4)";4290;4290;0;
3012065;"Zduny - rural area (5)";3307;0;3307;
3013000;"Powiat leszczyński";60254;5300;54954;
3013000;"Powiat leszczyński - URBAN-RURAL GMINAS";19961;5300;14661;
3013012;"Krzemieniewo (2)";7751;0;7751;
3013022;"Lipno (2)";10041;0;10041;
3013033;"Osieczna (3)";9322;2440;6882;
3013034;"Osieczna - urban area (4)";2440;2440;0;
3013035;"Osieczna - rural area (5)";6882;0;6882;
3013043;"Rydzyna (3)";10639;2860;7779;
3013044;"Rydzyna - urban area (4)";2860;2860;0;
3013045;"Rydzyna - rural area (5)";7779;0;7779;
3013052;"Święciechowa (2)";8822;0;8822;
3013062;"Wijewo (2)";3725;0;3725;
3013072;"Włoszakowice (2)";9954;0;9954;
3014000;"Powiat międzychodzki";35540;15702;19838;
3014000;"Powiat międzychodzki - URBAN-RURAL GMINAS";26283;15702;10581;
3014012;"Chrzypsko Wielkie (2)";3192;0;3192;
3014022;"Kwilcz (2)";6065;0;6065;
3014033;"Międzychód (3)";17802;9905;7897;
3014034;"Międzychód - urban area (4)";9905;9905;0;
3014035;"Międzychód - rural area (5)";7897;0;7897;
3014043;"Sieraków (3)";8481;5797;2684;
3014044;"Sieraków - urban area (4)";5797;5797;0;
3014045;"Sieraków - rural area (5)";2684;0;2684;
3015000;"Powiat nowotomyski";75150;32671;42479;
3015000;"Powiat nowotomyski - URBAN-RURAL GMINAS";66110;32671;33439;
3015012;"Kuślin (2)";5133;0;5133;
3015023;"Lwówek (3)";8691;2912;5779;
3015024;"Lwówek - urban area (4)";2912;2912;0;
3015025;"Lwówek - rural area (5)";5779;0;5779;
3015032;"Miedzichowo (2)";3907;0;3907;
3015043;"Nowy Tomyśl (3)";27799;13474;14325;
3015044;"Nowy Tomyśl - urban area (4)";13474;13474;0;
3015045;"Nowy Tomyśl - rural area (5)";14325;0;14325;
3015053;"Opalenica (3)";15941;9262;6679;
3015054;"Opalenica - urban area (4)";9262;9262;0;
3015055;"Opalenica - rural area (5)";6679;0;6679;
3015063;"Zbąszyń (3)";13679;7023;6656;
3015064;"Zbąszyń - urban area (4)";7023;7023;0;
3015065;"Zbąszyń - rural area (5)";6656;0;6656;
3016000;"Powiat obornicki";58730;27873;30857;
3016000;"Powiat obornicki - URBAN-RURAL GMINAS";51945;27873;24072;
3016013;"Oborniki (3)";34061;17139;16922;
3016014;"Oborniki - urban area (4)";17139;17139;0;
3016015;"Oborniki - rural area (5)";16922;0;16922;
3016023;"Rogoźno (3)";17884;10734;7150;
3016024;"Rogoźno - urban area (4)";10734;10734;0;
3016025;"Rogoźno - rural area (5)";7150;0;7150;
3016032;"Ryczywół (2)";6785;0;6785;
3017000;"Powiat ostrowski";158154;80519;77635;
3017000;"Powiat ostrowski - URBAN GMINAS";68949;68949;0;
3017000;"Powiat ostrowski - URBAN-RURAL GMINAS";41864;11570;30294;
3017011;"Ostrów Wielkopolski (1)";68949;68949;0;
3017023;"Nowe Skalmierzyce (3)";16006;4557;11449;
3017024;"Nowe Skalmierzyce - urban area (4)";4557;4557;0;
3017025;"Nowe Skalmierzyce - rural area (5)";11449;0;11449;
3017033;"Odolanów (3)";14462;4925;9537;
3017034;"Odolanów - urban area (4)";4925;4925;0;
3017035;"Odolanów - rural area (5)";9537;0;9537;
3017042;"Ostrów Wielkopolski (2)";19448;0;19448;
3017052;"Przygodzice (2)";12401;0;12401;
3017063;"Raszków (3)";11396;2088;9308;
3017064;"Raszków - urban area (4)";2088;2088;0;
3017065;"Raszków - rural area (5)";9308;0;9308;
3017072;"Sieroszewice (2)";9277;0;9277;
3017082;"Sośnie (2)";6215;0;6215;
3018000;"Powiat ostrzeszowski";54494;17083;37411;
3018000;"Powiat ostrzeszowski - URBAN-RURAL GMINAS";37211;17083;20128;
3018012;"Czajków (2)";2452;0;2452;
3018022;"Doruchów (2)";5049;0;5049;
3018033;"Grabów nad Prosną (3)";7706;1899;5807;
3018034;"Grabów nad Prosną - urban area (4)";1899;1899;0;
3018035;"Grabów nad Prosną - rural area (5)";5807;0;5807;
3018042;"Kobyla Góra (2)";6257;0;6257;
3018052;"Kraszewice (2)";3525;0;3525;
3018063;"Mikstat (3)";5798;1687;4111;
3018064;"Mikstat - urban area (4)";1687;1687;0;
3018065;"Mikstat - rural area (5)";4111;0;4111;
3018073;"Ostrzeszów (3)";23707;13497;10210;
3018074;"Ostrzeszów - urban area (4)";13497;13497;0;
3018075;"Ostrzeszów - rural area (5)";10210;0;10210;
3019000;"Powiat pilski";130059;87231;42828;
3019000;"Powiat pilski - URBAN GMINAS";69748;69748;0;
3019000;"Powiat pilski - URBAN-RURAL GMINAS";45999;17483;28516;
3019011;"Piła (1)";69748;69748;0;
3019022;"Białośliwie (2)";4514;0;4514;
3019033;"Kaczory (3)";7429;2757;4672;
3019034;"Kaczory - urban area (4)";2757;2757;0;
3019035;"Kaczory - rural area (5)";4672;0;4672;
3019043;"Łobżenica (3)";8960;2747;6213;
3019044;"Łobżenica - urban area (4)";2747;2747;0;
3019045;"Łobżenica - rural area (5)";6213;0;6213;
3019053;"Miasteczko Krajeńskie (3)";3043;1067;1976;
3019054;"Miasteczko Krajeńskie - urban area (4)";1067;1067;0;
3019055;"Miasteczko Krajeńskie - rural area (5)";1976;0;1976;
3019062;"Szydłowo (2)";9798;0;9798;
3019073;"Ujście (3)";7558;3335;4223;
3019074;"Ujście - urban area (4)";3335;3335;0;
3019075;"Ujście - rural area (5)";4223;0;4223;
3019083;"Wyrzysk (3)";12984;5071;7913;
3019084;"Wyrzysk - urban area (4)";5071;5071;0;
3019085;"Wyrzysk - rural area (5)";7913;0;7913;
3019093;"Wysoka (3)";6025;2506;3519;
3019094;"Wysoka - urban area (4)";2506;2506;0;
3019095;"Wysoka - rural area (5)";3519;0;3519;
3020000;"Powiat pleszewski";61082;21108;39974;
3020000;"Powiat pleszewski - URBAN-RURAL GMINAS";40869;21108;19761;
3020013;"Chocz (3)";4362;1610;2752;
3020014;"Chocz - urban area (4)";1610;1610;0;
3020015;"Chocz - rural area (5)";2752;0;2752;
3020022;"Czermin (2)";4786;0;4786;
3020033;"Dobrzyca (3)";7596;2919;4677;
3020034;"Dobrzyca - urban area (4)";2919;2919;0;
3020035;"Dobrzyca - rural area (5)";4677;0;4677;
3020042;"Gizałki (2)";4406;0;4406;
3020052;"Gołuchów (2)";11021;0;11021;
3020063;"Pleszew (3)";28911;16579;12332;
3020064;"Pleszew - urban area (4)";16579;16579;0;
3020065;"Pleszew - rural area (5)";12332;0;12332;
3021000;"Powiat poznański";451991;134171;317820;
3021000;"Powiat poznański - URBAN GMINAS";42106;42106;0;
3021000;"Powiat poznański - URBAN-RURAL GMINAS";217306;92065;125241;
3021011;"Luboń (1)";32849;32849;0;
3021021;"Puszczykowo (1)";9257;9257;0;
3021033;"Buk (3)";12944;5502;7442;
3021034;"Buk - urban area (4)";5502;5502;0;
3021035;"Buk - rural area (5)";7442;0;7442;
3021042;"Czerwonak (2)";28124;0;28124;
3021052;"Dopiewo (2)";36300;0;36300;
3021062;"Kleszczewo (2)";11864;0;11864;
3021072;"Komorniki (2)";36919;0;36919;
3021083;"Kostrzyn (3)";20510;9861;10649;
3021084;"Kostrzyn - urban area (4)";9861;9861;0;
3021085;"Kostrzyn - rural area (5)";10649;0;10649;
3021093;"Kórnik (3)";37371;8125;29246;
3021094;"Kórnik - urban area (4)";8125;8125;0;
3021095;"Kórnik - rural area (5)";29246;0;29246;
3021103;"Mosina (3)";35552;14491;21061;
3021104;"Mosina - urban area (4)";14491;14491;0;
3021105;"Mosina - rural area (5)";21061;0;21061;
3021113;"Murowana Goślina (3)";17070;10290;6780;
3021114;"Murowana Goślina - urban area (4)";10290;10290;0;
3021115;"Murowana Goślina - rural area (5)";6780;0;6780;
3021123;"Pobiedziska (3)";21426;9890;11536;
3021124;"Pobiedziska - urban area (4)";9890;9890;0;
3021125;"Pobiedziska - rural area (5)";11536;0;11536;
3021132;"Rokietnica (2)";24518;0;24518;
3021143;"Stęszew (3)";15560;5856;9704;
3021144;"Stęszew - urban area (4)";5856;5856;0;
3021145;"Stęszew - rural area (5)";9704;0;9704;
3021152;"Suchy Las (2)";20870;0;20870;
3021163;"Swarzędz (3)";56873;28050;28823;
3021164;"Swarzędz - urban area (4)";28050;28050;0;
3021165;"Swarzędz - rural area (5)";28823;0;28823;
3021172;"Tarnowo Podgórne (2)";33984;0;33984;
3022000;"Powiat rawicki";58495;27216;31279;
3022000;"Powiat rawicki - URBAN-RURAL GMINAS";53695;27216;26479;
3022013;"Bojanowo (3)";8163;2782;5381;
3022014;"Bojanowo - urban area (4)";2782;2782;0;
3022015;"Bojanowo - rural area (5)";5381;0;5381;
3022023;"Jutrosin (3)";6871;1844;5027;
3022024;"Jutrosin - urban area (4)";1844;1844;0;
3022025;"Jutrosin - rural area (5)";5027;0;5027;
3022033;"Miejska Górka (3)";8777;3041;5736;
3022034;"Miejska Górka - urban area (4)";3041;3041;0;
3022035;"Miejska Górka - rural area (5)";5736;0;5736;
3022042;"Pakosław (2)";4800;0;4800;
3022053;"Rawicz (3)";29884;19549;10335;
3022054;"Rawicz - urban area (4)";19549;19549;0;
3022055;"Rawicz - rural area (5)";10335;0;10335;
3023000;"Powiat słupecki";57108;15576;41532;
3023000;"Powiat słupecki - URBAN GMINAS";12855;12855;0;
3023000;"Powiat słupecki - URBAN-RURAL GMINAS";8438;2721;5717;
3023011;"Słupca (1)";12855;12855;0;
3023022;"Lądek (2)";5436;0;5436;
3023032;"Orchowo (2)";3550;0;3550;
3023042;"Ostrowite (2)";4741;0;4741;
3023052;"Powidz (2)";2226;0;2226;
3023062;"Słupca (2)";9952;0;9952;
3023072;"Strzałkowo (2)";9910;0;9910;
3023083;"Zagórów (3)";8438;2721;5717;
3023084;"Zagórów - urban area (4)";2721;2721;0;
3023085;"Zagórów - rural area (5)";5717;0;5717;
3024000;"Powiat szamotulski";91677;40907;50770;
3024000;"Powiat szamotulski - URBAN GMINAS";2384;2384;0;
3024000;"Powiat szamotulski - URBAN-RURAL GMINAS";65720;38523;27197;
3024011;"Obrzycko (1)";2384;2384;0;
3024022;"Duszniki (2)";9619;0;9619;
3024032;"Kaźmierz (2)";9535;0;9535;
3024042;"Obrzycko (2)";4419;0;4419;
3024053;"Ostroróg (3)";4739;1837;2902;
3024054;"Ostroróg - urban area (4)";1837;1837;0;
3024055;"Ostroróg - rural area (5)";2902;0;2902;
3024063;"Pniewy (3)";12345;8058;4287;
3024064;"Pniewy - urban area (4)";8058;8058;0;
3024065;"Pniewy - rural area (5)";4287;0;4287;
3024073;"Szamotuły (3)";29973;18178;11795;
3024074;"Szamotuły - urban area (4)";18178;18178;0;
3024075;"Szamotuły - rural area (5)";11795;0;11795;
3024083;"Wronki (3)";18663;10450;8213;
3024084;"Wronki - urban area (4)";10450;10450;0;
3024085;"Wronki - rural area (5)";8213;0;8213;
3025000;"Powiat średzki";60049;24333;35716;
3025000;"Powiat średzki - URBAN-RURAL GMINAS";33735;24333;9402;
3025012;"Dominowo (2)";3464;0;3464;
3025022;"Krzykosy (2)";7366;0;7366;
3025032;"Nowe Miasto nad Wartą (2)";8530;0;8530;
3025043;"Środa Wielkopolska (3)";33735;24333;9402;
3025044;"Środa Wielkopolska - urban area (4)";24333;24333;0;
3025045;"Środa Wielkopolska - rural area (5)";9402;0;9402;
3025052;"Zaniemyśl (2)";6954;0;6954;
3026000;"Powiat śremski";61018;32134;28884;
3026000;"Powiat śremski - URBAN-RURAL GMINAS";56263;32134;24129;
3026012;"Brodnica (2)";4755;0;4755;
3026023;"Dolsk (3)";5779;1551;4228;
3026024;"Dolsk - urban area (4)";1551;1551;0;
3026025;"Dolsk - rural area (5)";4228;0;4228;
3026033;"Książ Wielkopolski (3)";8012;2943;5069;
3026034;"Książ Wielkopolski - urban area (4)";2943;2943;0;
3026035;"Książ Wielkopolski - rural area (5)";5069;0;5069;
3026043;"Śrem (3)";42472;27640;14832;
3026044;"Śrem - urban area (4)";27640;27640;0;
3026045;"Śrem - rural area (5)";14832;0;14832;
3027000;"Powiat turecki";80795;28631;52164;
3027000;"Powiat turecki - URBAN GMINAS";24315;24315;0;
3027000;"Powiat turecki - URBAN-RURAL GMINAS";15906;4316;11590;
3027011;"Turek (1)";24315;24315;0;
3027022;"Brudzew (2)";5890;0;5890;
3027033;"Dobra (3)";5781;1311;4470;
3027034;"Dobra - urban area (4)";1311;1311;0;
3027035;"Dobra - rural area (5)";4470;0;4470;
3027042;"Kawęczyn (2)";4907;0;4907;
3027052;"Malanów (2)";6451;0;6451;
3027062;"Przykona (2)";4626;0;4626;
3027073;"Tuliszków (3)";10125;3005;7120;
3027074;"Tuliszków - urban area (4)";3005;3005;0;
3027075;"Tuliszków - rural area (5)";7120;0;7120;
3027082;"Turek (2)";10825;0;10825;
3027092;"Władysławów (2)";7875;0;7875;
3028000;"Powiat wągrowiecki";68897;35753;33144;
3028000;"Powiat wągrowiecki - URBAN GMINAS";25394;25394;0;
3028000;"Powiat wągrowiecki - URBAN-RURAL GMINAS";23553;10359;13194;
3028011;"Wągrowiec (1)";25394;25394;0;
3028022;"Damasławek (2)";4937;0;4937;
3028033;"Gołańcz (3)";7690;3150;4540;
3028034;"Gołańcz - urban area (4)";3150;3150;0;
3028035;"Gołańcz - rural area (5)";4540;0;4540;
3028043;"Mieścisko (3)";5651;2410;3241;
3028044;"Mieścisko - urban area (4)";2410;2410;0;
3028045;"Mieścisko - rural area (5)";3241;0;3241;
3028053;"Skoki (3)";10212;4799;5413;
3028054;"Skoki - urban area (4)";4799;4799;0;
3028055;"Skoki - rural area (5)";5413;0;5413;
3028062;"Wapno (2)";2668;0;2668;
3028072;"Wągrowiec (2)";12345;0;12345;
3029000;"Powiat wolsztyński";56584;11854;44730;
3029000;"Powiat wolsztyński - URBAN-RURAL GMINAS";30172;11854;18318;
3029012;"Przemęt (2)";13981;0;13981;
3029022;"Siedlec (2)";12431;0;12431;
3029033;"Wolsztyn (3)";30172;11854;18318;
3029034;"Wolsztyn - urban area (4)";11854;11854;0;
3029035;"Wolsztyn - rural area (5)";18318;0;18318;
3030000;"Powiat wrzesiński";78261;41924;36337;
3030000;"Powiat wrzesiński - URBAN-RURAL GMINAS";72719;41924;30795;
3030012;"Kołaczkowo (2)";5542;0;5542;
3030023;"Miłosław (3)";9774;3374;6400;
3030024;"Miłosław - urban area (4)";3374;3374;0;
3030025;"Miłosław - rural area (5)";6400;0;6400;
3030033;"Nekla (3)";7969;3856;4113;
3030034;"Nekla - urban area (4)";3856;3856;0;
3030035;"Nekla - rural area (5)";4113;0;4113;
3030043;"Pyzdry (3)";6476;2935;3541;
3030044;"Pyzdry - urban area (4)";2935;2935;0;
3030045;"Pyzdry - rural area (5)";3541;0;3541;
3030053;"Września (3)";48500;31759;16741;
3030054;"Września - urban area (4)";31759;31759;0;
3030055;"Września - rural area (5)";16741;0;16741;
3031000;"Powiat złotowski";67063;33297;33766;
3031000;"Powiat złotowski - URBAN GMINAS";18025;18025;0;
3031000;"Powiat złotowski - URBAN-RURAL GMINAS";25949;15272;10677;
3031011;"Złotów (1)";18025;18025;0;
3031023;"Jastrowie (3)";10762;8228;2534;
3031024;"Jastrowie - urban area (4)";8228;8228;0;
3031025;"Jastrowie - rural area (5)";2534;0;2534;
3031033;"Krajenka (3)";7332;3452;3880;
3031034;"Krajenka - urban area (4)";3452;3452;0;
3031035;"Krajenka - rural area (5)";3880;0;3880;
3031042;"Lipka (2)";5274;0;5274;
3031053;"Okonek (3)";7855;3592;4263;
3031054;"Okonek - urban area (4)";3592;3592;0;
3031055;"Okonek - rural area (5)";4263;0;4263;
3031062;"Tarnówka (2)";2987;0;2987;
3031072;"Zakrzewo (2)";4796;0;4796;
3031082;"Złotów (2)";10032;0;10032;
3061000;"City with powiat status Kalisz";92533;92533;0;
3061000;"City with powiat status Kalisz - URBAN GMINAS";92533;92533;0;
3061011;"Kalisz (1)";92533;92533;0;
3062000;"City with powiat status Konin";66606;66606;0;
3062000;"City with powiat status Konin - URBAN GMINAS";66606;66606;0;
3062011;"Konin (1)";66606;66606;0;
3063000;"City with powiat status Leszno";59840;59840;0;
3063000;"City with powiat status Leszno - URBAN GMINAS";59840;59840;0;
3063011;"Leszno (1)";59840;59840;0;
3064000;"City with powiat status Poznań";536818;536818;0;
3064000;"City with powiat status Poznań - URBAN GMINAS";536818;536818;0;
3064011;"Poznań (1)";536818;536818;0;
3201000;"Powiat białogardzki";44181;30089;14092;
3201000;"Powiat białogardzki - URBAN GMINAS";22300;22300;0;
3201000;"Powiat białogardzki - URBAN-RURAL GMINAS";14657;7789;6868;
3201011;"Białogard (1)";22300;22300;0;
3201022;"Białogard (2)";7224;0;7224;
3201033;"Karlino (3)";8470;5463;3007;
3201034;"Karlino - urban area (4)";5463;5463;0;
3201035;"Karlino - rural area (5)";3007;0;3007;
3201043;"Tychowo (3)";6187;2326;3861;
3201044;"Tychowo - urban area (4)";2326;2326;0;
3201045;"Tychowo - rural area (5)";3861;0;3861;
3202000;"Powiat choszczeński";44205;20995;23210;
3202000;"Powiat choszczeński - URBAN-RURAL GMINAS";36669;20995;15674;
3202012;"Bierzwnik (2)";4306;0;4306;
3202023;"Choszczno (3)";20038;13822;6216;
3202024;"Choszczno - urban area (4)";13822;13822;0;
3202025;"Choszczno - rural area (5)";6216;0;6216;
3202033;"Drawno (3)";4563;2150;2413;
3202034;"Drawno - urban area (4)";2150;2150;0;
3202035;"Drawno - rural area (5)";2413;0;2413;
3202042;"Krzęcin (2)";3230;0;3230;
3202053;"Pełczyce (3)";7128;2383;4745;
3202054;"Pełczyce - urban area (4)";2383;2383;0;
3202055;"Pełczyce - rural area (5)";4745;0;4745;
3202063;"Recz (3)";4940;2640;2300;
3202064;"Recz - urban area (4)";2640;2640;0;
3202065;"Recz - rural area (5)";2300;0;2300;
3203000;"Powiat drawski";53245;33834;19411;
3203000;"Powiat drawski - URBAN-RURAL GMINAS";49247;33834;15413;
3203013;"Czaplinek (3)";11065;6624;4441;
3203014;"Czaplinek - urban area (4)";6624;6624;0;
3203015;"Czaplinek - rural area (5)";4441;0;4441;
3203023;"Drawsko Pomorskie (3)";16236;11194;5042;
3203024;"Drawsko Pomorskie - urban area (4)";11194;11194;0;
3203025;"Drawsko Pomorskie - rural area (5)";5042;0;5042;
3203033;"Kalisz Pomorski (3)";6818;4032;2786;
3203034;"Kalisz Pomorski - urban area (4)";4032;4032;0;
3203035;"Kalisz Pomorski - rural area (5)";2786;0;2786;
3203052;"Wierzchowo (2)";3998;0;3998;
3203063;"Złocieniec (3)";15128;11984;3144;
3203064;"Złocieniec - urban area (4)";11984;11984;0;
3203065;"Złocieniec - rural area (5)";3144;0;3144;
3204000;"Powiat goleniowski";81189;42827;38362;
3204000;"Powiat goleniowski - URBAN-RURAL GMINAS";73527;42827;30700;
3204023;"Goleniów (3)";37000;21370;15630;
3204024;"Goleniów - urban area (4)";21370;21370;0;
3204025;"Goleniów - rural area (5)";15630;0;15630;
3204033;"Maszewo (3)";8523;3313;5210;
3204034;"Maszewo - urban area (4)";3313;3313;0;
3204035;"Maszewo - rural area (5)";5210;0;5210;
3204043;"Nowogard (3)";23322;15634;7688;
3204044;"Nowogard - urban area (4)";15634;15634;0;
3204045;"Nowogard - rural area (5)";7688;0;7688;
3204052;"Osina (2)";2872;0;2872;
3204062;"Przybiernów (2)";4790;0;4790;
3204073;"Stepnica (3)";4682;2510;2172;
3204074;"Stepnica - urban area (4)";2510;2510;0;
3204075;"Stepnica - rural area (5)";2172;0;2172;
3205000;"Powiat gryficki";56216;28258;27958;
3205000;"Powiat gryficki - URBAN-RURAL GMINAS";45468;28258;17210;
3205012;"Brojce (2)";3489;0;3489;
3205023;"Gryfice (3)";22638;15293;7345;
3205024;"Gryfice - urban area (4)";15293;15293;0;
3205025;"Gryfice - rural area (5)";7345;0;7345;
3205032;"Karnice (2)";3663;0;3663;
3205043;"Płoty (3)";8035;3691;4344;
3205044;"Płoty - urban area (4)";3691;3691;0;
3205045;"Płoty - rural area (5)";4344;0;4344;
3205072;"Rewal (2)";3596;0;3596;
3205083;"Trzebiatów (3)";14795;9274;5521;
3205084;"Trzebiatów - urban area (4)";9274;9274;0;
3205085;"Trzebiatów - rural area (5)";5521;0;5521;
3206000;"Powiat gryfiński";76713;35473;41240;
3206000;"Powiat gryfiński - URBAN-RURAL GMINAS";62375;35473;26902;
3206012;"Banie (2)";5722;0;5722;
3206023;"Cedynia (3)";3906;1444;2462;
3206024;"Cedynia - urban area (4)";1444;1444;0;
3206025;"Cedynia - rural area (5)";2462;0;2462;
3206033;"Chojna (3)";13051;7311;5740;
3206034;"Chojna - urban area (4)";7311;7311;0;
3206035;"Chojna - rural area (5)";5740;0;5740;
3206043;"Gryfino (3)";30048;19646;10402;
3206044;"Gryfino - urban area (4)";19646;19646;0;
3206045;"Gryfino - rural area (5)";10402;0;10402;
3206053;"Mieszkowice (3)";6492;3338;3154;
3206054;"Mieszkowice - urban area (4)";3338;3338;0;
3206055;"Mieszkowice - rural area (5)";3154;0;3154;
3206063;"Moryń (3)";4079;1618;2461;
3206064;"Moryń - urban area (4)";1618;1618;0;
3206065;"Moryń - rural area (5)";2461;0;2461;
3206072;"Stare Czarnowo (2)";3651;0;3651;
3206083;"Trzcińsko-Zdrój (3)";4799;2116;2683;
3206084;"Trzcińsko-Zdrój - urban area (4)";2116;2116;0;
3206085;"Trzcińsko-Zdrój - rural area (5)";2683;0;2683;
3206092;"Widuchowa (2)";4965;0;4965;
3207000;"Powiat kamieński";43950;22455;21495;
3207000;"Powiat kamieński - URBAN-RURAL GMINAS";39995;22455;17540;
3207013;"Dziwnów (3)";3523;2282;1241;
3207014;"Dziwnów - urban area (4)";2282;2282;0;
3207015;"Dziwnów - rural area (5)";1241;0;1241;
3207023;"Golczewo (3)";5489;2501;2988;
3207024;"Golczewo - urban area (4)";2501;2501;0;
3207025;"Golczewo - rural area (5)";2988;0;2988;
3207033;"Kamień Pomorski (3)";13387;8213;5174;
3207034;"Kamień Pomorski - urban area (4)";8213;8213;0;
3207035;"Kamień Pomorski - rural area (5)";5174;0;5174;
3207043;"Międzyzdroje (3)";5974;4842;1132;
3207044;"Międzyzdroje - urban area (4)";4842;4842;0;
3207045;"Międzyzdroje - rural area (5)";1132;0;1132;
3207052;"Świerzno (2)";3955;0;3955;
3207063;"Wolin (3)";11622;4617;7005;
3207064;"Wolin - urban area (4)";4617;4617;0;
3207065;"Wolin - rural area (5)";7005;0;7005;
3208000;"Powiat kołobrzeski";76562;46105;30457;
3208000;"Powiat kołobrzeski - URBAN GMINAS";43364;43364;0;
3208000;"Powiat kołobrzeski - URBAN-RURAL GMINAS";5330;2741;2589;
3208011;"Kołobrzeg (1)";43364;43364;0;
3208022;"Dygowo (2)";5297;0;5297;
3208033;"Gościno (3)";5330;2741;2589;
3208034;"Gościno - urban area (4)";2741;2741;0;
3208035;"Gościno - rural area (5)";2589;0;2589;
3208042;"Kołobrzeg (2)";11211;0;11211;
3208052;"Rymań (2)";3624;0;3624;
3208062;"Siemyśl (2)";4003;0;4003;
3208072;"Ustronie Morskie (2)";3733;0;3733;
3209000;"Powiat koszaliński";64459;15916;48543;
3209000;"Powiat koszaliński - URBAN-RURAL GMINAS";34827;15916;18911;
3209012;"Będzino (2)";8531;0;8531;
3209022;"Biesiekierz (2)";6789;0;6789;
3209033;"Bobolice (3)";8189;3680;4509;
3209034;"Bobolice - urban area (4)";3680;3680;0;
3209035;"Bobolice - rural area (5)";4509;0;4509;
3209042;"Manowo (2)";5700;0;5700;
3209053;"Mielno (3)";4641;2754;1887;
3209054;"Mielno - urban area (4)";2754;2754;0;
3209055;"Mielno - rural area (5)";1887;0;1887;
3209063;"Polanów (3)";7962;2819;5143;
3209064;"Polanów - urban area (4)";2819;2819;0;
3209065;"Polanów - rural area (5)";5143;0;5143;
3209073;"Sianów (3)";14035;6663;7372;
3209074;"Sianów - urban area (4)";6663;6663;0;
3209075;"Sianów - rural area (5)";7372;0;7372;
3209082;"Świeszyno (2)";8612;0;8612;
3210000;"Powiat myśliborski";61949;36006;25943;
3210000;"Powiat myśliborski - URBAN-RURAL GMINAS";55931;36006;19925;
3210013;"Barlinek (3)";18247;12878;5369;
3210014;"Barlinek - urban area (4)";12878;12878;0;
3210015;"Barlinek - rural area (5)";5369;0;5369;
3210022;"Boleszkowice (2)";2726;0;2726;
3210033;"Dębno (3)";19210;12800;6410;
3210034;"Dębno - urban area (4)";12800;12800;0;
3210035;"Dębno - rural area (5)";6410;0;6410;
3210043;"Myślibórz (3)";18474;10328;8146;
3210044;"Myślibórz - urban area (4)";10328;10328;0;
3210045;"Myślibórz - rural area (5)";8146;0;8146;
3210052;"Nowogródek Pomorski (2)";3292;0;3292;
3211000;"Powiat policki";86489;30455;56034;
3211000;"Powiat policki - URBAN-RURAL GMINAS";40457;30455;10002;
3211012;"Dobra (Szczecińska) (2)";30549;0;30549;
3211022;"Kołbaskowo (2)";15483;0;15483;
3211033;"Nowe Warpno (3)";1523;1050;473;
3211034;"Nowe Warpno - urban area (4)";1050;1050;0;
3211035;"Nowe Warpno - rural area (5)";473;0;473;
3211043;"Police (3)";38934;29405;9529;
3211044;"Police - urban area (4)";29405;29405;0;
3211045;"Police - rural area (5)";9529;0;9529;
3212000;"Powiat pyrzycki";36239;15532;20707;
3212000;"Powiat pyrzycki - URBAN-RURAL GMINAS";23479;15532;7947;
3212012;"Bielice (2)";2930;0;2930;
3212022;"Kozielice (2)";2355;0;2355;
3212033;"Lipiany (3)";5413;3766;1647;
3212034;"Lipiany - urban area (4)";3766;3766;0;
3212035;"Lipiany - rural area (5)";1647;0;1647;
3212042;"Przelewice (2)";4454;0;4454;
3212053;"Pyrzyce (3)";18066;11766;6300;
3212054;"Pyrzyce - urban area (4)";11766;11766;0;
3212055;"Pyrzyce - rural area (5)";6300;0;6300;
3212062;"Warnice (2)";3021;0;3021;
3213000;"Powiat sławieński";52695;24191;28504;
3213000;"Powiat sławieński - URBAN GMINAS";24191;24191;0;
3213011;"Darłowo (1)";12466;12466;0;
3213021;"Sławno (1)";11725;11725;0;
3213032;"Darłowo (2)";7563;0;7563;
3213042;"Malechowo (2)";5896;0;5896;
3213052;"Postomino (2)";6756;0;6756;
3213062;"Sławno (2)";8289;0;8289;
3214000;"Powiat stargardzki";118947;74536;44411;
3214000;"Powiat stargardzki - URBAN GMINAS";66272;66272;0;
3214000;"Powiat stargardzki - URBAN-RURAL GMINAS";17032;8264;8768;
3214011;"Stargard (1)";66272;66272;0;
3214023;"Chociwel (3)";5433;2974;2459;
3214024;"Chociwel - urban area (4)";2974;2974;0;
3214025;"Chociwel - rural area (5)";2459;0;2459;
3214033;"Dobrzany (3)";4478;2143;2335;
3214034;"Dobrzany - urban area (4)";2143;2143;0;
3214035;"Dobrzany - rural area (5)";2335;0;2335;
3214042;"Dolice (2)";7035;0;7035;
3214053;"Ińsko (3)";3061;1752;1309;
3214054;"Ińsko - urban area (4)";1752;1752;0;
3214055;"Ińsko - rural area (5)";1309;0;1309;
3214062;"Kobylanka (2)";6671;0;6671;
3214082;"Marianowo (2)";2885;0;2885;
3214092;"Stara Dąbrowa (2)";3521;0;3521;
3214102;"Stargard (2)";15531;0;15531;
3214113;"Suchań (3)";4060;1395;2665;
3214114;"Suchań - urban area (4)";1395;1395;0;
3214115;"Suchań - rural area (5)";2665;0;2665;
3215000;"Powiat szczecinecki";72393;47798;24595;
3215000;"Powiat szczecinecki - URBAN GMINAS";37421;37421;0;
3215000;"Powiat szczecinecki - URBAN-RURAL GMINAS";21872;10377;11495;
3215011;"Szczecinek (1)";37421;37421;0;
3215023;"Barwice (3)";7748;3425;4323;
3215024;"Barwice - urban area (4)";3425;3425;0;
3215025;"Barwice - rural area (5)";4323;0;4323;
3215033;"Biały Bór (3)";4950;2130;2820;
3215034;"Biały Bór - urban area (4)";2130;2130;0;
3215035;"Biały Bór - rural area (5)";2820;0;2820;
3215043;"Borne Sulinowo (3)";9174;4822;4352;
3215044;"Borne Sulinowo - urban area (4)";4822;4822;0;
3215045;"Borne Sulinowo - rural area (5)";4352;0;4352;
3215052;"Grzmiąca (2)";4270;0;4270;
3215062;"Szczecinek (2)";8830;0;8830;
3216000;"Powiat świdwiński";42996;21663;21333;
3216000;"Powiat świdwiński - URBAN GMINAS";14470;14470;0;
3216000;"Powiat świdwiński - URBAN-RURAL GMINAS";13632;7193;6439;
3216011;"Świdwin (1)";14470;14470;0;
3216022;"Brzeżno (2)";2548;0;2548;
3216033;"Połczyn-Zdrój (3)";13632;7193;6439;
3216034;"Połczyn-Zdrój - urban area (4)";7193;7193;0;
3216035;"Połczyn-Zdrój - rural area (5)";6439;0;6439;
3216042;"Rąbino (2)";3251;0;3251;
3216052;"Sławoborze (2)";3792;0;3792;
3216062;"Świdwin (2)";5303;0;5303;
3217000;"Powiat wałecki";49705;30335;19370;
3217000;"Powiat wałecki - URBAN GMINAS";23422;23422;0;
3217000;"Powiat wałecki - URBAN-RURAL GMINAS";14233;6913;7320;
3217011;"Wałcz (1)";23422;23422;0;
3217023;"Człopa (3)";4508;2138;2370;
3217024;"Człopa - urban area (4)";2138;2138;0;
3217025;"Człopa - rural area (5)";2370;0;2370;
3217033;"Mirosławiec (3)";5293;3010;2283;
3217034;"Mirosławiec - urban area (4)";3010;3010;0;
3217035;"Mirosławiec - rural area (5)";2283;0;2283;
3217043;"Tuczno (3)";4432;1765;2667;
3217044;"Tuczno - urban area (4)";1765;1765;0;
3217045;"Tuczno - rural area (5)";2667;0;2667;
3217052;"Wałcz (2)";12050;0;12050;
3218000;"Powiat łobeski";33172;17955;15217;
3218000;"Powiat łobeski - URBAN-RURAL GMINAS";30009;17955;12054;
3218013;"Dobra (3)";3837;2005;1832;
3218014;"Dobra - urban area (4)";2005;2005;0;
3218015;"Dobra - rural area (5)";1832;0;1832;
3218023;"Łobez (3)";12731;9486;3245;
3218024;"Łobez - urban area (4)";9486;9486;0;
3218025;"Łobez - rural area (5)";3245;0;3245;
3218032;"Radowo Małe (2)";3163;0;3163;
3218043;"Resko (3)";7158;3853;3305;
3218044;"Resko - urban area (4)";3853;3853;0;
3218045;"Resko - rural area (5)";3305;0;3305;
3218053;"Węgorzyno (3)";6283;2611;3672;
3218054;"Węgorzyno - urban area (4)";2611;2611;0;
3218055;"Węgorzyno - rural area (5)";3672;0;3672;
3261000;"City with powiat status Koszalin";105143;105143;0;
3261000;"City with powiat status Koszalin - URBAN GMINAS";105143;105143;0;
3261011;"Koszalin (1)";105143;105143;0;
3262000;"City with powiat status Szczecin";387700;387700;0;
3262000;"City with powiat status Szczecin - URBAN GMINAS";387700;387700;0;
3262011;"Szczecin (1)";387700;387700;0;
3263000;"City with powiat status Świnoujście";38728;38728;0;
3263000;"City with powiat status Świnoujście - URBAN GMINAS";38728;38728;0;
3263011;"Świnoujście (1)";38728;38728;0;
